Id,Id2,Geography,Total,Occupied,Vacant
1000000US210670001001000,210670001001000,"Block 1000, Block Group 1, Census Tract 1, Fayette County, Kentucky",0,0,0
1000000US210670001001001,210670001001001,"Block 1001, Block Group 1, Census Tract 1, Fayette County, Kentucky",5,5,0
1000000US210670001001002,210670001001002,"Block 1002, Block Group 1, Census Tract 1, Fayette County, Kentucky",0,0,0
1000000US210670001001003,210670001001003,"Block 1003, Block Group 1, Census Tract 1, Fayette County, Kentucky",5,4,1
1000000US210670001001004,210670001001004,"Block 1004, Block Group 1, Census Tract 1, Fayette County, Kentucky",24,21,3
1000000US210670001001005,210670001001005,"Block 1005, Block Group 1, Census Tract 1, Fayette County, Kentucky",180,141,39
1000000US210670001001006,210670001001006,"Block 1006, Block Group 1, Census Tract 1, Fayette County, Kentucky",7,7,0
1000000US210670001001007,210670001001007,"Block 1007, Block Group 1, Census Tract 1, Fayette County, Kentucky",63,59,4
1000000US210670001001008,210670001001008,"Block 1008, Block Group 1, Census Tract 1, Fayette County, Kentucky",33,29,4
1000000US210670001001009,210670001001009,"Block 1009, Block Group 1, Census Tract 1, Fayette County, Kentucky",1,0,1
1000000US210670001001010,210670001001010,"Block 1010, Block Group 1, Census Tract 1, Fayette County, Kentucky",17,17,0
1000000US210670001001011,210670001001011,"Block 1011, Block Group 1, Census Tract 1, Fayette County, Kentucky",322,197,125
1000000US210670001001012,210670001001012,"Block 1012, Block Group 1, Census Tract 1, Fayette County, Kentucky",38,23,15
1000000US210670001001013,210670001001013,"Block 1013, Block Group 1, Census Tract 1, Fayette County, Kentucky",26,24,2
1000000US210670001001014,210670001001014,"Block 1014, Block Group 1, Census Tract 1, Fayette County, Kentucky",22,19,3
1000000US210670001001015,210670001001015,"Block 1015, Block Group 1, Census Tract 1, Fayette County, Kentucky",16,15,1
1000000US210670001001016,210670001001016,"Block 1016, Block Group 1, Census Tract 1, Fayette County, Kentucky",47,44,3
1000000US210670001001017,210670001001017,"Block 1017, Block Group 1, Census Tract 1, Fayette County, Kentucky",52,48,4
1000000US210670001001018,210670001001018,"Block 1018, Block Group 1, Census Tract 1, Fayette County, Kentucky",11,11,0
1000000US210670001001019,210670001001019,"Block 1019, Block Group 1, Census Tract 1, Fayette County, Kentucky",1,1,0
1000000US210670001001020,210670001001020,"Block 1020, Block Group 1, Census Tract 1, Fayette County, Kentucky",21,19,2
1000000US210670001001021,210670001001021,"Block 1021, Block Group 1, Census Tract 1, Fayette County, Kentucky",18,15,3
1000000US210670001001022,210670001001022,"Block 1022, Block Group 1, Census Tract 1, Fayette County, Kentucky",5,5,0
1000000US210670001001023,210670001001023,"Block 1023, Block Group 1, Census Tract 1, Fayette County, Kentucky",38,22,16
1000000US210670001001024,210670001001024,"Block 1024, Block Group 1, Census Tract 1, Fayette County, Kentucky",19,16,3
1000000US210670001001025,210670001001025,"Block 1025, Block Group 1, Census Tract 1, Fayette County, Kentucky",4,3,1
1000000US210670001001026,210670001001026,"Block 1026, Block Group 1, Census Tract 1, Fayette County, Kentucky",2,2,0
1000000US210670001001027,210670001001027,"Block 1027, Block Group 1, Census Tract 1, Fayette County, Kentucky",0,0,0
1000000US210670001001028,210670001001028,"Block 1028, Block Group 1, Census Tract 1, Fayette County, Kentucky",2,2,0
1000000US210670001001029,210670001001029,"Block 1029, Block Group 1, Census Tract 1, Fayette County, Kentucky",1,1,0
1000000US210670001001030,210670001001030,"Block 1030, Block Group 1, Census Tract 1, Fayette County, Kentucky",3,3,0
1000000US210670001001031,210670001001031,"Block 1031, Block Group 1, Census Tract 1, Fayette County, Kentucky",2,2,0
1000000US210670001001032,210670001001032,"Block 1032, Block Group 1, Census Tract 1, Fayette County, Kentucky",9,7,2
1000000US210670001001033,210670001001033,"Block 1033, Block Group 1, Census Tract 1, Fayette County, Kentucky",1,1,0
1000000US210670001001034,210670001001034,"Block 1034, Block Group 1, Census Tract 1, Fayette County, Kentucky",0,0,0
1000000US210670001002000,210670001002000,"Block 2000, Block Group 2, Census Tract 1, Fayette County, Kentucky",1,1,0
1000000US210670001002001,210670001002001,"Block 2001, Block Group 2, Census Tract 1, Fayette County, Kentucky",39,19,20
1000000US210670001002002,210670001002002,"Block 2002, Block Group 2, Census Tract 1, Fayette County, Kentucky",0,0,0
1000000US210670001002003,210670001002003,"Block 2003, Block Group 2, Census Tract 1, Fayette County, Kentucky",0,0,0
1000000US210670001002004,210670001002004,"Block 2004, Block Group 2, Census Tract 1, Fayette County, Kentucky",0,0,0
1000000US210670001002005,210670001002005,"Block 2005, Block Group 2, Census Tract 1, Fayette County, Kentucky",0,0,0
1000000US210670001002006,210670001002006,"Block 2006, Block Group 2, Census Tract 1, Fayette County, Kentucky",54,48,6
1000000US210670001002007,210670001002007,"Block 2007, Block Group 2, Census Tract 1, Fayette County, Kentucky",48,37,11
1000000US210670001002008,210670001002008,"Block 2008, Block Group 2, Census Tract 1, Fayette County, Kentucky",0,0,0
1000000US210670001002009,210670001002009,"Block 2009, Block Group 2, Census Tract 1, Fayette County, Kentucky",22,21,1
1000000US210670001002010,210670001002010,"Block 2010, Block Group 2, Census Tract 1, Fayette County, Kentucky",56,46,10
1000000US210670001002011,210670001002011,"Block 2011, Block Group 2, Census Tract 1, Fayette County, Kentucky",19,15,4
1000000US210670001002012,210670001002012,"Block 2012, Block Group 2, Census Tract 1, Fayette County, Kentucky",0,0,0
1000000US210670001002013,210670001002013,"Block 2013, Block Group 2, Census Tract 1, Fayette County, Kentucky",0,0,0
1000000US210670001002014,210670001002014,"Block 2014, Block Group 2, Census Tract 1, Fayette County, Kentucky",7,6,1
1000000US210670001002015,210670001002015,"Block 2015, Block Group 2, Census Tract 1, Fayette County, Kentucky",15,11,4
1000000US210670001002016,210670001002016,"Block 2016, Block Group 2, Census Tract 1, Fayette County, Kentucky",49,47,2
1000000US210670001002017,210670001002017,"Block 2017, Block Group 2, Census Tract 1, Fayette County, Kentucky",29,29,0
1000000US210670001002018,210670001002018,"Block 2018, Block Group 2, Census Tract 1, Fayette County, Kentucky",0,0,0
1000000US210670001002019,210670001002019,"Block 2019, Block Group 2, Census Tract 1, Fayette County, Kentucky",56,49,7
1000000US210670001003000,210670001003000,"Block 3000, Block Group 3, Census Tract 1, Fayette County, Kentucky",0,0,0
1000000US210670001003001,210670001003001,"Block 3001, Block Group 3, Census Tract 1, Fayette County, Kentucky",0,0,0
1000000US210670001003002,210670001003002,"Block 3002, Block Group 3, Census Tract 1, Fayette County, Kentucky",0,0,0
1000000US210670001003003,210670001003003,"Block 3003, Block Group 3, Census Tract 1, Fayette County, Kentucky",15,12,3
1000000US210670001003004,210670001003004,"Block 3004, Block Group 3, Census Tract 1, Fayette County, Kentucky",18,14,4
1000000US210670001003005,210670001003005,"Block 3005, Block Group 3, Census Tract 1, Fayette County, Kentucky",29,22,7
1000000US210670001003006,210670001003006,"Block 3006, Block Group 3, Census Tract 1, Fayette County, Kentucky",67,59,8
1000000US210670001003007,210670001003007,"Block 3007, Block Group 3, Census Tract 1, Fayette County, Kentucky",6,4,2
1000000US210670001003008,210670001003008,"Block 3008, Block Group 3, Census Tract 1, Fayette County, Kentucky",2,1,1
1000000US210670001003009,210670001003009,"Block 3009, Block Group 3, Census Tract 1, Fayette County, Kentucky",14,12,2
1000000US210670001003010,210670001003010,"Block 3010, Block Group 3, Census Tract 1, Fayette County, Kentucky",10,10,0
1000000US210670001003011,210670001003011,"Block 3011, Block Group 3, Census Tract 1, Fayette County, Kentucky",10,10,0
1000000US210670001003012,210670001003012,"Block 3012, Block Group 3, Census Tract 1, Fayette County, Kentucky",8,8,0
1000000US210670001003013,210670001003013,"Block 3013, Block Group 3, Census Tract 1, Fayette County, Kentucky",21,19,2
1000000US210670001003014,210670001003014,"Block 3014, Block Group 3, Census Tract 1, Fayette County, Kentucky",0,0,0
1000000US210670001003015,210670001003015,"Block 3015, Block Group 3, Census Tract 1, Fayette County, Kentucky",3,3,0
1000000US210670001003016,210670001003016,"Block 3016, Block Group 3, Census Tract 1, Fayette County, Kentucky",0,0,0
1000000US210670001003017,210670001003017,"Block 3017, Block Group 3, Census Tract 1, Fayette County, Kentucky",0,0,0
1000000US210670001003018,210670001003018,"Block 3018, Block Group 3, Census Tract 1, Fayette County, Kentucky",0,0,0
1000000US210670001003019,210670001003019,"Block 3019, Block Group 3, Census Tract 1, Fayette County, Kentucky",0,0,0
1000000US210670001003020,210670001003020,"Block 3020, Block Group 3, Census Tract 1, Fayette County, Kentucky",23,20,3
1000000US210670001003021,210670001003021,"Block 3021, Block Group 3, Census Tract 1, Fayette County, Kentucky",45,41,4
1000000US210670001003022,210670001003022,"Block 3022, Block Group 3, Census Tract 1, Fayette County, Kentucky",0,0,0
1000000US210670001003023,210670001003023,"Block 3023, Block Group 3, Census Tract 1, Fayette County, Kentucky",1,0,1
1000000US210670001003024,210670001003024,"Block 3024, Block Group 3, Census Tract 1, Fayette County, Kentucky",4,2,2
1000000US210670001003025,210670001003025,"Block 3025, Block Group 3, Census Tract 1, Fayette County, Kentucky",69,69,0
1000000US210670001003026,210670001003026,"Block 3026, Block Group 3, Census Tract 1, Fayette County, Kentucky",0,0,0
1000000US210670001003027,210670001003027,"Block 3027, Block Group 3, Census Tract 1, Fayette County, Kentucky",102,98,4
1000000US210670001003028,210670001003028,"Block 3028, Block Group 3, Census Tract 1, Fayette County, Kentucky",0,0,0
1000000US210670001003029,210670001003029,"Block 3029, Block Group 3, Census Tract 1, Fayette County, Kentucky",45,36,9
1000000US210670001003030,210670001003030,"Block 3030, Block Group 3, Census Tract 1, Fayette County, Kentucky",40,36,4
1000000US210670001003031,210670001003031,"Block 3031, Block Group 3, Census Tract 1, Fayette County, Kentucky",5,3,2
1000000US210670001003032,210670001003032,"Block 3032, Block Group 3, Census Tract 1, Fayette County, Kentucky",6,6,0
1000000US210670001003033,210670001003033,"Block 3033, Block Group 3, Census Tract 1, Fayette County, Kentucky",17,16,1
1000000US210670001003034,210670001003034,"Block 3034, Block Group 3, Census Tract 1, Fayette County, Kentucky",3,3,0
1000000US210670001003035,210670001003035,"Block 3035, Block Group 3, Census Tract 1, Fayette County, Kentucky",13,13,0
1000000US210670001003036,210670001003036,"Block 3036, Block Group 3, Census Tract 1, Fayette County, Kentucky",17,17,0
1000000US210670001003037,210670001003037,"Block 3037, Block Group 3, Census Tract 1, Fayette County, Kentucky",17,14,3
1000000US210670001003038,210670001003038,"Block 3038, Block Group 3, Census Tract 1, Fayette County, Kentucky",5,5,0
1000000US210670001003039,210670001003039,"Block 3039, Block Group 3, Census Tract 1, Fayette County, Kentucky",0,0,0
1000000US210670001003040,210670001003040,"Block 3040, Block Group 3, Census Tract 1, Fayette County, Kentucky",0,0,0
1000000US210670001003041,210670001003041,"Block 3041, Block Group 3, Census Tract 1, Fayette County, Kentucky",0,0,0
1000000US210670001003042,210670001003042,"Block 3042, Block Group 3, Census Tract 1, Fayette County, Kentucky",0,0,0
1000000US210670001003043,210670001003043,"Block 3043, Block Group 3, Census Tract 1, Fayette County, Kentucky",0,0,0
1000000US210670001003044,210670001003044,"Block 3044, Block Group 3, Census Tract 1, Fayette County, Kentucky",0,0,0
1000000US210670001004000,210670001004000,"Block 4000, Block Group 4, Census Tract 1, Fayette County, Kentucky",0,0,0
1000000US210670001004001,210670001004001,"Block 4001, Block Group 4, Census Tract 1, Fayette County, Kentucky",0,0,0
1000000US210670001004002,210670001004002,"Block 4002, Block Group 4, Census Tract 1, Fayette County, Kentucky",0,0,0
1000000US210670001004003,210670001004003,"Block 4003, Block Group 4, Census Tract 1, Fayette County, Kentucky",0,0,0
1000000US210670001004004,210670001004004,"Block 4004, Block Group 4, Census Tract 1, Fayette County, Kentucky",199,189,10
1000000US210670001004005,210670001004005,"Block 4005, Block Group 4, Census Tract 1, Fayette County, Kentucky",5,5,0
1000000US210670001004006,210670001004006,"Block 4006, Block Group 4, Census Tract 1, Fayette County, Kentucky",1,1,0
1000000US210670001004007,210670001004007,"Block 4007, Block Group 4, Census Tract 1, Fayette County, Kentucky",110,95,15
1000000US210670001004008,210670001004008,"Block 4008, Block Group 4, Census Tract 1, Fayette County, Kentucky",13,12,1
1000000US210670001004009,210670001004009,"Block 4009, Block Group 4, Census Tract 1, Fayette County, Kentucky",11,5,6
1000000US210670001004010,210670001004010,"Block 4010, Block Group 4, Census Tract 1, Fayette County, Kentucky",0,0,0
1000000US210670001004011,210670001004011,"Block 4011, Block Group 4, Census Tract 1, Fayette County, Kentucky",0,0,0
1000000US210670001004012,210670001004012,"Block 4012, Block Group 4, Census Tract 1, Fayette County, Kentucky",0,0,0
1000000US210670001004013,210670001004013,"Block 4013, Block Group 4, Census Tract 1, Fayette County, Kentucky",0,0,0
1000000US210670001004014,210670001004014,"Block 4014, Block Group 4, Census Tract 1, Fayette County, Kentucky",0,0,0
1000000US210670001004015,210670001004015,"Block 4015, Block Group 4, Census Tract 1, Fayette County, Kentucky",4,4,0
1000000US210670001004016,210670001004016,"Block 4016, Block Group 4, Census Tract 1, Fayette County, Kentucky",33,26,7
1000000US210670001004017,210670001004017,"Block 4017, Block Group 4, Census Tract 1, Fayette County, Kentucky",79,59,20
1000000US210670001004018,210670001004018,"Block 4018, Block Group 4, Census Tract 1, Fayette County, Kentucky",86,80,6
1000000US210670001004019,210670001004019,"Block 4019, Block Group 4, Census Tract 1, Fayette County, Kentucky",153,144,9
1000000US210670001004020,210670001004020,"Block 4020, Block Group 4, Census Tract 1, Fayette County, Kentucky",106,100,6
1000000US210670001004021,210670001004021,"Block 4021, Block Group 4, Census Tract 1, Fayette County, Kentucky",46,46,0
1000000US210670001004022,210670001004022,"Block 4022, Block Group 4, Census Tract 1, Fayette County, Kentucky",3,3,0
1000000US210670001004023,210670001004023,"Block 4023, Block Group 4, Census Tract 1, Fayette County, Kentucky",47,45,2
1000000US210670001004024,210670001004024,"Block 4024, Block Group 4, Census Tract 1, Fayette County, Kentucky",0,0,0
1000000US210670001004025,210670001004025,"Block 4025, Block Group 4, Census Tract 1, Fayette County, Kentucky",0,0,0
1000000US210670001004026,210670001004026,"Block 4026, Block Group 4, Census Tract 1, Fayette County, Kentucky",168,152,16
1000000US210670001004027,210670001004027,"Block 4027, Block Group 4, Census Tract 1, Fayette County, Kentucky",0,0,0
1000000US210670002001000,210670002001000,"Block 1000, Block Group 1, Census Tract 2, Fayette County, Kentucky",0,0,0
1000000US210670002001001,210670002001001,"Block 1001, Block Group 1, Census Tract 2, Fayette County, Kentucky",6,3,3
1000000US210670002001002,210670002001002,"Block 1002, Block Group 1, Census Tract 2, Fayette County, Kentucky",111,109,2
1000000US210670002001003,210670002001003,"Block 1003, Block Group 1, Census Tract 2, Fayette County, Kentucky",8,5,3
1000000US210670002001004,210670002001004,"Block 1004, Block Group 1, Census Tract 2, Fayette County, Kentucky",1,1,0
1000000US210670002001005,210670002001005,"Block 1005, Block Group 1, Census Tract 2, Fayette County, Kentucky",38,37,1
1000000US210670002001006,210670002001006,"Block 1006, Block Group 1, Census Tract 2, Fayette County, Kentucky",68,63,5
1000000US210670002001007,210670002001007,"Block 1007, Block Group 1, Census Tract 2, Fayette County, Kentucky",5,5,0
1000000US210670002001008,210670002001008,"Block 1008, Block Group 1, Census Tract 2, Fayette County, Kentucky",23,22,1
1000000US210670002001009,210670002001009,"Block 1009, Block Group 1, Census Tract 2, Fayette County, Kentucky",18,16,2
1000000US210670002001010,210670002001010,"Block 1010, Block Group 1, Census Tract 2, Fayette County, Kentucky",84,74,10
1000000US210670002001011,210670002001011,"Block 1011, Block Group 1, Census Tract 2, Fayette County, Kentucky",32,30,2
1000000US210670002002000,210670002002000,"Block 2000, Block Group 2, Census Tract 2, Fayette County, Kentucky",0,0,0
1000000US210670002002001,210670002002001,"Block 2001, Block Group 2, Census Tract 2, Fayette County, Kentucky",23,19,4
1000000US210670002002002,210670002002002,"Block 2002, Block Group 2, Census Tract 2, Fayette County, Kentucky",29,26,3
1000000US210670002002003,210670002002003,"Block 2003, Block Group 2, Census Tract 2, Fayette County, Kentucky",38,36,2
1000000US210670002002004,210670002002004,"Block 2004, Block Group 2, Census Tract 2, Fayette County, Kentucky",22,18,4
1000000US210670002002005,210670002002005,"Block 2005, Block Group 2, Census Tract 2, Fayette County, Kentucky",19,16,3
1000000US210670002002006,210670002002006,"Block 2006, Block Group 2, Census Tract 2, Fayette County, Kentucky",20,19,1
1000000US210670002002007,210670002002007,"Block 2007, Block Group 2, Census Tract 2, Fayette County, Kentucky",34,33,1
1000000US210670002002008,210670002002008,"Block 2008, Block Group 2, Census Tract 2, Fayette County, Kentucky",2,2,0
1000000US210670002002009,210670002002009,"Block 2009, Block Group 2, Census Tract 2, Fayette County, Kentucky",10,9,1
1000000US210670002002010,210670002002010,"Block 2010, Block Group 2, Census Tract 2, Fayette County, Kentucky",36,27,9
1000000US210670002002011,210670002002011,"Block 2011, Block Group 2, Census Tract 2, Fayette County, Kentucky",26,21,5
1000000US210670002003000,210670002003000,"Block 3000, Block Group 3, Census Tract 2, Fayette County, Kentucky",51,38,13
1000000US210670002003001,210670002003001,"Block 3001, Block Group 3, Census Tract 2, Fayette County, Kentucky",17,15,2
1000000US210670002003002,210670002003002,"Block 3002, Block Group 3, Census Tract 2, Fayette County, Kentucky",79,68,11
1000000US210670002003003,210670002003003,"Block 3003, Block Group 3, Census Tract 2, Fayette County, Kentucky",30,27,3
1000000US210670002003004,210670002003004,"Block 3004, Block Group 3, Census Tract 2, Fayette County, Kentucky",42,38,4
1000000US210670002003005,210670002003005,"Block 3005, Block Group 3, Census Tract 2, Fayette County, Kentucky",12,10,2
1000000US210670002003006,210670002003006,"Block 3006, Block Group 3, Census Tract 2, Fayette County, Kentucky",27,22,5
1000000US210670002003007,210670002003007,"Block 3007, Block Group 3, Census Tract 2, Fayette County, Kentucky",1,1,0
1000000US210670002003008,210670002003008,"Block 3008, Block Group 3, Census Tract 2, Fayette County, Kentucky",59,49,10
1000000US210670002003009,210670002003009,"Block 3009, Block Group 3, Census Tract 2, Fayette County, Kentucky",36,31,5
1000000US210670002003010,210670002003010,"Block 3010, Block Group 3, Census Tract 2, Fayette County, Kentucky",32,23,9
1000000US210670002003011,210670002003011,"Block 3011, Block Group 3, Census Tract 2, Fayette County, Kentucky",28,23,5
1000000US210670002003012,210670002003012,"Block 3012, Block Group 3, Census Tract 2, Fayette County, Kentucky",6,6,0
1000000US210670002003013,210670002003013,"Block 3013, Block Group 3, Census Tract 2, Fayette County, Kentucky",17,16,1
1000000US210670002003014,210670002003014,"Block 3014, Block Group 3, Census Tract 2, Fayette County, Kentucky",0,0,0
1000000US210670002004000,210670002004000,"Block 4000, Block Group 4, Census Tract 2, Fayette County, Kentucky",16,14,2
1000000US210670002004001,210670002004001,"Block 4001, Block Group 4, Census Tract 2, Fayette County, Kentucky",45,42,3
1000000US210670002004002,210670002004002,"Block 4002, Block Group 4, Census Tract 2, Fayette County, Kentucky",38,30,8
1000000US210670002004003,210670002004003,"Block 4003, Block Group 4, Census Tract 2, Fayette County, Kentucky",41,31,10
1000000US210670002004004,210670002004004,"Block 4004, Block Group 4, Census Tract 2, Fayette County, Kentucky",95,83,12
1000000US210670002004005,210670002004005,"Block 4005, Block Group 4, Census Tract 2, Fayette County, Kentucky",19,19,0
1000000US210670002004006,210670002004006,"Block 4006, Block Group 4, Census Tract 2, Fayette County, Kentucky",0,0,0
1000000US210670002004007,210670002004007,"Block 4007, Block Group 4, Census Tract 2, Fayette County, Kentucky",10,9,1
1000000US210670002004008,210670002004008,"Block 4008, Block Group 4, Census Tract 2, Fayette County, Kentucky",4,3,1
1000000US210670002004009,210670002004009,"Block 4009, Block Group 4, Census Tract 2, Fayette County, Kentucky",14,13,1
1000000US210670002004010,210670002004010,"Block 4010, Block Group 4, Census Tract 2, Fayette County, Kentucky",66,54,12
1000000US210670002004011,210670002004011,"Block 4011, Block Group 4, Census Tract 2, Fayette County, Kentucky",0,0,0
1000000US210670002004012,210670002004012,"Block 4012, Block Group 4, Census Tract 2, Fayette County, Kentucky",15,12,3
1000000US210670002004013,210670002004013,"Block 4013, Block Group 4, Census Tract 2, Fayette County, Kentucky",4,4,0
1000000US210670002004014,210670002004014,"Block 4014, Block Group 4, Census Tract 2, Fayette County, Kentucky",55,39,16
1000000US210670002004015,210670002004015,"Block 4015, Block Group 4, Census Tract 2, Fayette County, Kentucky",41,33,8
1000000US210670002004016,210670002004016,"Block 4016, Block Group 4, Census Tract 2, Fayette County, Kentucky",9,8,1
1000000US210670002004017,210670002004017,"Block 4017, Block Group 4, Census Tract 2, Fayette County, Kentucky",0,0,0
1000000US210670002004018,210670002004018,"Block 4018, Block Group 4, Census Tract 2, Fayette County, Kentucky",0,0,0
1000000US210670002004019,210670002004019,"Block 4019, Block Group 4, Census Tract 2, Fayette County, Kentucky",0,0,0
1000000US210670002004020,210670002004020,"Block 4020, Block Group 4, Census Tract 2, Fayette County, Kentucky",0,0,0
1000000US210670002004021,210670002004021,"Block 4021, Block Group 4, Census Tract 2, Fayette County, Kentucky",3,2,1
1000000US210670003001000,210670003001000,"Block 1000, Block Group 1, Census Tract 3, Fayette County, Kentucky",44,40,4
1000000US210670003001001,210670003001001,"Block 1001, Block Group 1, Census Tract 3, Fayette County, Kentucky",7,6,1
1000000US210670003001002,210670003001002,"Block 1002, Block Group 1, Census Tract 3, Fayette County, Kentucky",24,22,2
1000000US210670003001003,210670003001003,"Block 1003, Block Group 1, Census Tract 3, Fayette County, Kentucky",30,30,0
1000000US210670003001004,210670003001004,"Block 1004, Block Group 1, Census Tract 3, Fayette County, Kentucky",13,12,1
1000000US210670003001005,210670003001005,"Block 1005, Block Group 1, Census Tract 3, Fayette County, Kentucky",47,40,7
1000000US210670003001006,210670003001006,"Block 1006, Block Group 1, Census Tract 3, Fayette County, Kentucky",51,44,7
1000000US210670003001007,210670003001007,"Block 1007, Block Group 1, Census Tract 3, Fayette County, Kentucky",27,22,5
1000000US210670003001008,210670003001008,"Block 1008, Block Group 1, Census Tract 3, Fayette County, Kentucky",29,23,6
1000000US210670003001009,210670003001009,"Block 1009, Block Group 1, Census Tract 3, Fayette County, Kentucky",16,13,3
1000000US210670003001010,210670003001010,"Block 1010, Block Group 1, Census Tract 3, Fayette County, Kentucky",37,35,2
1000000US210670003001011,210670003001011,"Block 1011, Block Group 1, Census Tract 3, Fayette County, Kentucky",27,25,2
1000000US210670003002000,210670003002000,"Block 2000, Block Group 2, Census Tract 3, Fayette County, Kentucky",41,38,3
1000000US210670003002001,210670003002001,"Block 2001, Block Group 2, Census Tract 3, Fayette County, Kentucky",53,41,12
1000000US210670003002002,210670003002002,"Block 2002, Block Group 2, Census Tract 3, Fayette County, Kentucky",50,33,17
1000000US210670003002003,210670003002003,"Block 2003, Block Group 2, Census Tract 3, Fayette County, Kentucky",46,40,6
1000000US210670003002004,210670003002004,"Block 2004, Block Group 2, Census Tract 3, Fayette County, Kentucky",47,42,5
1000000US210670003002005,210670003002005,"Block 2005, Block Group 2, Census Tract 3, Fayette County, Kentucky",16,14,2
1000000US210670003002006,210670003002006,"Block 2006, Block Group 2, Census Tract 3, Fayette County, Kentucky",10,10,0
1000000US210670003002007,210670003002007,"Block 2007, Block Group 2, Census Tract 3, Fayette County, Kentucky",10,8,2
1000000US210670003003000,210670003003000,"Block 3000, Block Group 3, Census Tract 3, Fayette County, Kentucky",45,41,4
1000000US210670003003001,210670003003001,"Block 3001, Block Group 3, Census Tract 3, Fayette County, Kentucky",43,38,5
1000000US210670003003002,210670003003002,"Block 3002, Block Group 3, Census Tract 3, Fayette County, Kentucky",90,80,10
1000000US210670003003003,210670003003003,"Block 3003, Block Group 3, Census Tract 3, Fayette County, Kentucky",32,27,5
1000000US210670003003004,210670003003004,"Block 3004, Block Group 3, Census Tract 3, Fayette County, Kentucky",42,38,4
1000000US210670003003005,210670003003005,"Block 3005, Block Group 3, Census Tract 3, Fayette County, Kentucky",21,17,4
1000000US210670003004000,210670003004000,"Block 4000, Block Group 4, Census Tract 3, Fayette County, Kentucky",116,84,32
1000000US210670003004001,210670003004001,"Block 4001, Block Group 4, Census Tract 3, Fayette County, Kentucky",9,5,4
1000000US210670003004002,210670003004002,"Block 4002, Block Group 4, Census Tract 3, Fayette County, Kentucky",21,16,5
1000000US210670003004003,210670003004003,"Block 4003, Block Group 4, Census Tract 3, Fayette County, Kentucky",31,25,6
1000000US210670003004004,210670003004004,"Block 4004, Block Group 4, Census Tract 3, Fayette County, Kentucky",90,75,15
1000000US210670003004005,210670003004005,"Block 4005, Block Group 4, Census Tract 3, Fayette County, Kentucky",32,28,4
1000000US210670003004006,210670003004006,"Block 4006, Block Group 4, Census Tract 3, Fayette County, Kentucky",34,32,2
1000000US210670003004007,210670003004007,"Block 4007, Block Group 4, Census Tract 3, Fayette County, Kentucky",21,20,1
1000000US210670003004008,210670003004008,"Block 4008, Block Group 4, Census Tract 3, Fayette County, Kentucky",21,18,3
1000000US210670003004009,210670003004009,"Block 4009, Block Group 4, Census Tract 3, Fayette County, Kentucky",30,21,9
1000000US210670003004010,210670003004010,"Block 4010, Block Group 4, Census Tract 3, Fayette County, Kentucky",28,20,8
1000000US210670003005000,210670003005000,"Block 5000, Block Group 5, Census Tract 3, Fayette County, Kentucky",34,29,5
1000000US210670003005001,210670003005001,"Block 5001, Block Group 5, Census Tract 3, Fayette County, Kentucky",4,4,0
1000000US210670003005002,210670003005002,"Block 5002, Block Group 5, Census Tract 3, Fayette County, Kentucky",18,14,4
1000000US210670003005003,210670003005003,"Block 5003, Block Group 5, Census Tract 3, Fayette County, Kentucky",80,74,6
1000000US210670003005004,210670003005004,"Block 5004, Block Group 5, Census Tract 3, Fayette County, Kentucky",17,15,2
1000000US210670003005005,210670003005005,"Block 5005, Block Group 5, Census Tract 3, Fayette County, Kentucky",60,52,8
1000000US210670003005006,210670003005006,"Block 5006, Block Group 5, Census Tract 3, Fayette County, Kentucky",28,22,6
1000000US210670003005007,210670003005007,"Block 5007, Block Group 5, Census Tract 3, Fayette County, Kentucky",4,3,1
1000000US210670003005008,210670003005008,"Block 5008, Block Group 5, Census Tract 3, Fayette County, Kentucky",26,18,8
1000000US210670003005009,210670003005009,"Block 5009, Block Group 5, Census Tract 3, Fayette County, Kentucky",15,13,2
1000000US210670003005010,210670003005010,"Block 5010, Block Group 5, Census Tract 3, Fayette County, Kentucky",11,11,0
1000000US210670003005011,210670003005011,"Block 5011, Block Group 5, Census Tract 3, Fayette County, Kentucky",31,28,3
1000000US210670003005012,210670003005012,"Block 5012, Block Group 5, Census Tract 3, Fayette County, Kentucky",15,13,2
1000000US210670004001000,210670004001000,"Block 1000, Block Group 1, Census Tract 4, Fayette County, Kentucky",10,10,0
1000000US210670004001001,210670004001001,"Block 1001, Block Group 1, Census Tract 4, Fayette County, Kentucky",13,13,0
1000000US210670004001002,210670004001002,"Block 1002, Block Group 1, Census Tract 4, Fayette County, Kentucky",11,11,0
1000000US210670004001003,210670004001003,"Block 1003, Block Group 1, Census Tract 4, Fayette County, Kentucky",5,5,0
1000000US210670004001004,210670004001004,"Block 1004, Block Group 1, Census Tract 4, Fayette County, Kentucky",12,10,2
1000000US210670004001005,210670004001005,"Block 1005, Block Group 1, Census Tract 4, Fayette County, Kentucky",18,17,1
1000000US210670004001006,210670004001006,"Block 1006, Block Group 1, Census Tract 4, Fayette County, Kentucky",19,18,1
1000000US210670004001007,210670004001007,"Block 1007, Block Group 1, Census Tract 4, Fayette County, Kentucky",18,18,0
1000000US210670004001008,210670004001008,"Block 1008, Block Group 1, Census Tract 4, Fayette County, Kentucky",20,19,1
1000000US210670004001009,210670004001009,"Block 1009, Block Group 1, Census Tract 4, Fayette County, Kentucky",6,5,1
1000000US210670004001010,210670004001010,"Block 1010, Block Group 1, Census Tract 4, Fayette County, Kentucky",18,17,1
1000000US210670004001011,210670004001011,"Block 1011, Block Group 1, Census Tract 4, Fayette County, Kentucky",3,3,0
1000000US210670004001012,210670004001012,"Block 1012, Block Group 1, Census Tract 4, Fayette County, Kentucky",0,0,0
1000000US210670004001013,210670004001013,"Block 1013, Block Group 1, Census Tract 4, Fayette County, Kentucky",1,1,0
1000000US210670004002000,210670004002000,"Block 2000, Block Group 2, Census Tract 4, Fayette County, Kentucky",31,28,3
1000000US210670004002001,210670004002001,"Block 2001, Block Group 2, Census Tract 4, Fayette County, Kentucky",11,10,1
1000000US210670004002002,210670004002002,"Block 2002, Block Group 2, Census Tract 4, Fayette County, Kentucky",8,8,0
1000000US210670004002003,210670004002003,"Block 2003, Block Group 2, Census Tract 4, Fayette County, Kentucky",28,27,1
1000000US210670004002004,210670004002004,"Block 2004, Block Group 2, Census Tract 4, Fayette County, Kentucky",29,25,4
1000000US210670004002005,210670004002005,"Block 2005, Block Group 2, Census Tract 4, Fayette County, Kentucky",54,40,14
1000000US210670004002006,210670004002006,"Block 2006, Block Group 2, Census Tract 4, Fayette County, Kentucky",16,15,1
1000000US210670004002007,210670004002007,"Block 2007, Block Group 2, Census Tract 4, Fayette County, Kentucky",20,20,0
1000000US210670004002008,210670004002008,"Block 2008, Block Group 2, Census Tract 4, Fayette County, Kentucky",0,0,0
1000000US210670004002009,210670004002009,"Block 2009, Block Group 2, Census Tract 4, Fayette County, Kentucky",0,0,0
1000000US210670004002010,210670004002010,"Block 2010, Block Group 2, Census Tract 4, Fayette County, Kentucky",0,0,0
1000000US210670004002011,210670004002011,"Block 2011, Block Group 2, Census Tract 4, Fayette County, Kentucky",0,0,0
1000000US210670004002012,210670004002012,"Block 2012, Block Group 2, Census Tract 4, Fayette County, Kentucky",0,0,0
1000000US210670004003000,210670004003000,"Block 3000, Block Group 3, Census Tract 4, Fayette County, Kentucky",0,0,0
1000000US210670004003001,210670004003001,"Block 3001, Block Group 3, Census Tract 4, Fayette County, Kentucky",1,0,1
1000000US210670004003002,210670004003002,"Block 3002, Block Group 3, Census Tract 4, Fayette County, Kentucky",65,58,7
1000000US210670004003003,210670004003003,"Block 3003, Block Group 3, Census Tract 4, Fayette County, Kentucky",502,378,124
1000000US210670004003004,210670004003004,"Block 3004, Block Group 3, Census Tract 4, Fayette County, Kentucky",62,24,38
1000000US210670004003005,210670004003005,"Block 3005, Block Group 3, Census Tract 4, Fayette County, Kentucky",47,24,23
1000000US210670004003006,210670004003006,"Block 3006, Block Group 3, Census Tract 4, Fayette County, Kentucky",11,4,7
1000000US210670004003007,210670004003007,"Block 3007, Block Group 3, Census Tract 4, Fayette County, Kentucky",50,45,5
1000000US210670004003008,210670004003008,"Block 3008, Block Group 3, Census Tract 4, Fayette County, Kentucky",28,26,2
1000000US210670004003009,210670004003009,"Block 3009, Block Group 3, Census Tract 4, Fayette County, Kentucky",8,5,3
1000000US210670004003010,210670004003010,"Block 3010, Block Group 3, Census Tract 4, Fayette County, Kentucky",0,0,0
1000000US210670004003011,210670004003011,"Block 3011, Block Group 3, Census Tract 4, Fayette County, Kentucky",0,0,0
1000000US210670004003012,210670004003012,"Block 3012, Block Group 3, Census Tract 4, Fayette County, Kentucky",0,0,0
1000000US210670004003013,210670004003013,"Block 3013, Block Group 3, Census Tract 4, Fayette County, Kentucky",6,5,1
1000000US210670005001000,210670005001000,"Block 1000, Block Group 1, Census Tract 5, Fayette County, Kentucky",14,12,2
1000000US210670005001001,210670005001001,"Block 1001, Block Group 1, Census Tract 5, Fayette County, Kentucky",38,37,1
1000000US210670005001002,210670005001002,"Block 1002, Block Group 1, Census Tract 5, Fayette County, Kentucky",0,0,0
1000000US210670005001003,210670005001003,"Block 1003, Block Group 1, Census Tract 5, Fayette County, Kentucky",34,31,3
1000000US210670005001004,210670005001004,"Block 1004, Block Group 1, Census Tract 5, Fayette County, Kentucky",27,20,7
1000000US210670005001005,210670005001005,"Block 1005, Block Group 1, Census Tract 5, Fayette County, Kentucky",53,47,6
1000000US210670005001006,210670005001006,"Block 1006, Block Group 1, Census Tract 5, Fayette County, Kentucky",21,21,0
1000000US210670005001007,210670005001007,"Block 1007, Block Group 1, Census Tract 5, Fayette County, Kentucky",22,21,1
1000000US210670005001008,210670005001008,"Block 1008, Block Group 1, Census Tract 5, Fayette County, Kentucky",25,24,1
1000000US210670005001009,210670005001009,"Block 1009, Block Group 1, Census Tract 5, Fayette County, Kentucky",16,13,3
1000000US210670005001010,210670005001010,"Block 1010, Block Group 1, Census Tract 5, Fayette County, Kentucky",51,48,3
1000000US210670005001011,210670005001011,"Block 1011, Block Group 1, Census Tract 5, Fayette County, Kentucky",46,42,4
1000000US210670005001012,210670005001012,"Block 1012, Block Group 1, Census Tract 5, Fayette County, Kentucky",0,0,0
1000000US210670005001013,210670005001013,"Block 1013, Block Group 1, Census Tract 5, Fayette County, Kentucky",37,36,1
1000000US210670005001014,210670005001014,"Block 1014, Block Group 1, Census Tract 5, Fayette County, Kentucky",19,17,2
1000000US210670005001015,210670005001015,"Block 1015, Block Group 1, Census Tract 5, Fayette County, Kentucky",27,26,1
1000000US210670005001016,210670005001016,"Block 1016, Block Group 1, Census Tract 5, Fayette County, Kentucky",22,21,1
1000000US210670005002000,210670005002000,"Block 2000, Block Group 2, Census Tract 5, Fayette County, Kentucky",97,91,6
1000000US210670005002001,210670005002001,"Block 2001, Block Group 2, Census Tract 5, Fayette County, Kentucky",0,0,0
1000000US210670005002002,210670005002002,"Block 2002, Block Group 2, Census Tract 5, Fayette County, Kentucky",0,0,0
1000000US210670005002003,210670005002003,"Block 2003, Block Group 2, Census Tract 5, Fayette County, Kentucky",20,20,0
1000000US210670005002004,210670005002004,"Block 2004, Block Group 2, Census Tract 5, Fayette County, Kentucky",52,47,5
1000000US210670005002005,210670005002005,"Block 2005, Block Group 2, Census Tract 5, Fayette County, Kentucky",57,53,4
1000000US210670005002006,210670005002006,"Block 2006, Block Group 2, Census Tract 5, Fayette County, Kentucky",44,41,3
1000000US210670005002007,210670005002007,"Block 2007, Block Group 2, Census Tract 5, Fayette County, Kentucky",50,48,2
1000000US210670005002008,210670005002008,"Block 2008, Block Group 2, Census Tract 5, Fayette County, Kentucky",41,40,1
1000000US210670005002009,210670005002009,"Block 2009, Block Group 2, Census Tract 5, Fayette County, Kentucky",42,38,4
1000000US210670005002010,210670005002010,"Block 2010, Block Group 2, Census Tract 5, Fayette County, Kentucky",81,75,6
1000000US210670005003000,210670005003000,"Block 3000, Block Group 3, Census Tract 5, Fayette County, Kentucky",86,82,4
1000000US210670005003001,210670005003001,"Block 3001, Block Group 3, Census Tract 5, Fayette County, Kentucky",15,15,0
1000000US210670005003002,210670005003002,"Block 3002, Block Group 3, Census Tract 5, Fayette County, Kentucky",25,25,0
1000000US210670005003003,210670005003003,"Block 3003, Block Group 3, Census Tract 5, Fayette County, Kentucky",89,79,10
1000000US210670005003004,210670005003004,"Block 3004, Block Group 3, Census Tract 5, Fayette County, Kentucky",134,125,9
1000000US210670005003005,210670005003005,"Block 3005, Block Group 3, Census Tract 5, Fayette County, Kentucky",17,16,1
1000000US210670005003006,210670005003006,"Block 3006, Block Group 3, Census Tract 5, Fayette County, Kentucky",60,58,2
1000000US210670005003007,210670005003007,"Block 3007, Block Group 3, Census Tract 5, Fayette County, Kentucky",39,36,3
1000000US210670005004000,210670005004000,"Block 4000, Block Group 4, Census Tract 5, Fayette County, Kentucky",50,45,5
1000000US210670005004001,210670005004001,"Block 4001, Block Group 4, Census Tract 5, Fayette County, Kentucky",49,45,4
1000000US210670005004002,210670005004002,"Block 4002, Block Group 4, Census Tract 5, Fayette County, Kentucky",54,51,3
1000000US210670005004003,210670005004003,"Block 4003, Block Group 4, Census Tract 5, Fayette County, Kentucky",78,69,9
1000000US210670005004004,210670005004004,"Block 4004, Block Group 4, Census Tract 5, Fayette County, Kentucky",64,64,0
1000000US210670005004005,210670005004005,"Block 4005, Block Group 4, Census Tract 5, Fayette County, Kentucky",49,47,2
1000000US210670005004006,210670005004006,"Block 4006, Block Group 4, Census Tract 5, Fayette County, Kentucky",51,50,1
1000000US210670005004007,210670005004007,"Block 4007, Block Group 4, Census Tract 5, Fayette County, Kentucky",40,39,1
1000000US210670006001000,210670006001000,"Block 1000, Block Group 1, Census Tract 6, Fayette County, Kentucky",21,19,2
1000000US210670006001001,210670006001001,"Block 1001, Block Group 1, Census Tract 6, Fayette County, Kentucky",20,20,0
1000000US210670006001002,210670006001002,"Block 1002, Block Group 1, Census Tract 6, Fayette County, Kentucky",43,41,2
1000000US210670006001003,210670006001003,"Block 1003, Block Group 1, Census Tract 6, Fayette County, Kentucky",56,55,1
1000000US210670006001004,210670006001004,"Block 1004, Block Group 1, Census Tract 6, Fayette County, Kentucky",1,1,0
1000000US210670006001005,210670006001005,"Block 1005, Block Group 1, Census Tract 6, Fayette County, Kentucky",28,23,5
1000000US210670006001006,210670006001006,"Block 1006, Block Group 1, Census Tract 6, Fayette County, Kentucky",37,34,3
1000000US210670006001007,210670006001007,"Block 1007, Block Group 1, Census Tract 6, Fayette County, Kentucky",24,24,0
1000000US210670006001008,210670006001008,"Block 1008, Block Group 1, Census Tract 6, Fayette County, Kentucky",24,24,0
1000000US210670006001009,210670006001009,"Block 1009, Block Group 1, Census Tract 6, Fayette County, Kentucky",56,55,1
1000000US210670006001010,210670006001010,"Block 1010, Block Group 1, Census Tract 6, Fayette County, Kentucky",23,21,2
1000000US210670006001011,210670006001011,"Block 1011, Block Group 1, Census Tract 6, Fayette County, Kentucky",24,24,0
1000000US210670006001012,210670006001012,"Block 1012, Block Group 1, Census Tract 6, Fayette County, Kentucky",35,33,2
1000000US210670006001013,210670006001013,"Block 1013, Block Group 1, Census Tract 6, Fayette County, Kentucky",111,105,6
1000000US210670006001014,210670006001014,"Block 1014, Block Group 1, Census Tract 6, Fayette County, Kentucky",111,106,5
1000000US210670006001015,210670006001015,"Block 1015, Block Group 1, Census Tract 6, Fayette County, Kentucky",37,36,1
1000000US210670006001016,210670006001016,"Block 1016, Block Group 1, Census Tract 6, Fayette County, Kentucky",28,28,0
1000000US210670006001017,210670006001017,"Block 1017, Block Group 1, Census Tract 6, Fayette County, Kentucky",21,21,0
1000000US210670006002000,210670006002000,"Block 2000, Block Group 2, Census Tract 6, Fayette County, Kentucky",2,2,0
1000000US210670006002001,210670006002001,"Block 2001, Block Group 2, Census Tract 6, Fayette County, Kentucky",34,32,2
1000000US210670006002002,210670006002002,"Block 2002, Block Group 2, Census Tract 6, Fayette County, Kentucky",35,35,0
1000000US210670006002003,210670006002003,"Block 2003, Block Group 2, Census Tract 6, Fayette County, Kentucky",48,44,4
1000000US210670006002004,210670006002004,"Block 2004, Block Group 2, Census Tract 6, Fayette County, Kentucky",0,0,0
1000000US210670006002005,210670006002005,"Block 2005, Block Group 2, Census Tract 6, Fayette County, Kentucky",49,46,3
1000000US210670006002006,210670006002006,"Block 2006, Block Group 2, Census Tract 6, Fayette County, Kentucky",64,63,1
1000000US210670006002007,210670006002007,"Block 2007, Block Group 2, Census Tract 6, Fayette County, Kentucky",30,28,2
1000000US210670006002008,210670006002008,"Block 2008, Block Group 2, Census Tract 6, Fayette County, Kentucky",31,30,1
1000000US210670006002009,210670006002009,"Block 2009, Block Group 2, Census Tract 6, Fayette County, Kentucky",267,258,9
1000000US210670006002010,210670006002010,"Block 2010, Block Group 2, Census Tract 6, Fayette County, Kentucky",47,42,5
1000000US210670006002011,210670006002011,"Block 2011, Block Group 2, Census Tract 6, Fayette County, Kentucky",20,17,3
1000000US210670006002012,210670006002012,"Block 2012, Block Group 2, Census Tract 6, Fayette County, Kentucky",8,8,0
1000000US210670006002013,210670006002013,"Block 2013, Block Group 2, Census Tract 6, Fayette County, Kentucky",57,54,3
1000000US210670006002014,210670006002014,"Block 2014, Block Group 2, Census Tract 6, Fayette County, Kentucky",18,16,2
1000000US210670006002015,210670006002015,"Block 2015, Block Group 2, Census Tract 6, Fayette County, Kentucky",0,0,0
1000000US210670006002016,210670006002016,"Block 2016, Block Group 2, Census Tract 6, Fayette County, Kentucky",29,28,1
1000000US210670006002017,210670006002017,"Block 2017, Block Group 2, Census Tract 6, Fayette County, Kentucky",45,45,0
1000000US210670006002018,210670006002018,"Block 2018, Block Group 2, Census Tract 6, Fayette County, Kentucky",42,42,0
1000000US210670006002019,210670006002019,"Block 2019, Block Group 2, Census Tract 6, Fayette County, Kentucky",0,0,0
1000000US210670006003000,210670006003000,"Block 3000, Block Group 3, Census Tract 6, Fayette County, Kentucky",32,28,4
1000000US210670006003001,210670006003001,"Block 3001, Block Group 3, Census Tract 6, Fayette County, Kentucky",40,40,0
1000000US210670006003002,210670006003002,"Block 3002, Block Group 3, Census Tract 6, Fayette County, Kentucky",128,101,27
1000000US210670006003003,210670006003003,"Block 3003, Block Group 3, Census Tract 6, Fayette County, Kentucky",33,30,3
1000000US210670006003004,210670006003004,"Block 3004, Block Group 3, Census Tract 6, Fayette County, Kentucky",33,30,3
1000000US210670006003005,210670006003005,"Block 3005, Block Group 3, Census Tract 6, Fayette County, Kentucky",22,19,3
1000000US210670006003006,210670006003006,"Block 3006, Block Group 3, Census Tract 6, Fayette County, Kentucky",9,9,0
1000000US210670006003007,210670006003007,"Block 3007, Block Group 3, Census Tract 6, Fayette County, Kentucky",45,39,6
1000000US210670006003008,210670006003008,"Block 3008, Block Group 3, Census Tract 6, Fayette County, Kentucky",68,46,22
1000000US210670006003009,210670006003009,"Block 3009, Block Group 3, Census Tract 6, Fayette County, Kentucky",61,59,2
1000000US210670006003010,210670006003010,"Block 3010, Block Group 3, Census Tract 6, Fayette County, Kentucky",73,70,3
1000000US210670006003011,210670006003011,"Block 3011, Block Group 3, Census Tract 6, Fayette County, Kentucky",171,153,18
1000000US210670006003012,210670006003012,"Block 3012, Block Group 3, Census Tract 6, Fayette County, Kentucky",58,56,2
1000000US210670006003013,210670006003013,"Block 3013, Block Group 3, Census Tract 6, Fayette County, Kentucky",56,53,3
1000000US210670006003014,210670006003014,"Block 3014, Block Group 3, Census Tract 6, Fayette County, Kentucky",29,28,1
1000000US210670006003015,210670006003015,"Block 3015, Block Group 3, Census Tract 6, Fayette County, Kentucky",46,44,2
1000000US210670006003016,210670006003016,"Block 3016, Block Group 3, Census Tract 6, Fayette County, Kentucky",2,2,0
1000000US210670006003017,210670006003017,"Block 3017, Block Group 3, Census Tract 6, Fayette County, Kentucky",17,16,1
1000000US210670006003018,210670006003018,"Block 3018, Block Group 3, Census Tract 6, Fayette County, Kentucky",43,42,1
1000000US210670006003019,210670006003019,"Block 3019, Block Group 3, Census Tract 6, Fayette County, Kentucky",22,22,0
1000000US210670007001000,210670007001000,"Block 1000, Block Group 1, Census Tract 7, Fayette County, Kentucky",9,8,1
1000000US210670007001001,210670007001001,"Block 1001, Block Group 1, Census Tract 7, Fayette County, Kentucky",44,42,2
1000000US210670007001002,210670007001002,"Block 1002, Block Group 1, Census Tract 7, Fayette County, Kentucky",55,47,8
1000000US210670007001003,210670007001003,"Block 1003, Block Group 1, Census Tract 7, Fayette County, Kentucky",0,0,0
1000000US210670007001004,210670007001004,"Block 1004, Block Group 1, Census Tract 7, Fayette County, Kentucky",45,39,6
1000000US210670007001005,210670007001005,"Block 1005, Block Group 1, Census Tract 7, Fayette County, Kentucky",45,44,1
1000000US210670007001006,210670007001006,"Block 1006, Block Group 1, Census Tract 7, Fayette County, Kentucky",34,31,3
1000000US210670007001007,210670007001007,"Block 1007, Block Group 1, Census Tract 7, Fayette County, Kentucky",25,24,1
1000000US210670007001008,210670007001008,"Block 1008, Block Group 1, Census Tract 7, Fayette County, Kentucky",9,8,1
1000000US210670007001009,210670007001009,"Block 1009, Block Group 1, Census Tract 7, Fayette County, Kentucky",37,37,0
1000000US210670007001010,210670007001010,"Block 1010, Block Group 1, Census Tract 7, Fayette County, Kentucky",75,72,3
1000000US210670007001011,210670007001011,"Block 1011, Block Group 1, Census Tract 7, Fayette County, Kentucky",53,47,6
1000000US210670007001012,210670007001012,"Block 1012, Block Group 1, Census Tract 7, Fayette County, Kentucky",182,173,9
1000000US210670007001013,210670007001013,"Block 1013, Block Group 1, Census Tract 7, Fayette County, Kentucky",23,23,0
1000000US210670007001014,210670007001014,"Block 1014, Block Group 1, Census Tract 7, Fayette County, Kentucky",25,24,1
1000000US210670007002000,210670007002000,"Block 2000, Block Group 2, Census Tract 7, Fayette County, Kentucky",0,0,0
1000000US210670007002001,210670007002001,"Block 2001, Block Group 2, Census Tract 7, Fayette County, Kentucky",73,71,2
1000000US210670007002002,210670007002002,"Block 2002, Block Group 2, Census Tract 7, Fayette County, Kentucky",0,0,0
1000000US210670007002003,210670007002003,"Block 2003, Block Group 2, Census Tract 7, Fayette County, Kentucky",17,17,0
1000000US210670007002004,210670007002004,"Block 2004, Block Group 2, Census Tract 7, Fayette County, Kentucky",39,36,3
1000000US210670007002005,210670007002005,"Block 2005, Block Group 2, Census Tract 7, Fayette County, Kentucky",20,19,1
1000000US210670007002006,210670007002006,"Block 2006, Block Group 2, Census Tract 7, Fayette County, Kentucky",41,39,2
1000000US210670007002007,210670007002007,"Block 2007, Block Group 2, Census Tract 7, Fayette County, Kentucky",22,18,4
1000000US210670007002008,210670007002008,"Block 2008, Block Group 2, Census Tract 7, Fayette County, Kentucky",35,35,0
1000000US210670007002009,210670007002009,"Block 2009, Block Group 2, Census Tract 7, Fayette County, Kentucky",39,39,0
1000000US210670007002010,210670007002010,"Block 2010, Block Group 2, Census Tract 7, Fayette County, Kentucky",24,22,2
1000000US210670007002011,210670007002011,"Block 2011, Block Group 2, Census Tract 7, Fayette County, Kentucky",22,22,0
1000000US210670007002012,210670007002012,"Block 2012, Block Group 2, Census Tract 7, Fayette County, Kentucky",20,19,1
1000000US210670007002013,210670007002013,"Block 2013, Block Group 2, Census Tract 7, Fayette County, Kentucky",18,18,0
1000000US210670007002014,210670007002014,"Block 2014, Block Group 2, Census Tract 7, Fayette County, Kentucky",26,25,1
1000000US210670007002015,210670007002015,"Block 2015, Block Group 2, Census Tract 7, Fayette County, Kentucky",23,23,0
1000000US210670007002016,210670007002016,"Block 2016, Block Group 2, Census Tract 7, Fayette County, Kentucky",16,14,2
1000000US210670007002017,210670007002017,"Block 2017, Block Group 2, Census Tract 7, Fayette County, Kentucky",11,11,0
1000000US210670008011000,210670008011000,"Block 1000, Block Group 1, Census Tract 8.01, Fayette County, Kentucky",386,373,13
1000000US210670008011001,210670008011001,"Block 1001, Block Group 1, Census Tract 8.01, Fayette County, Kentucky",10,7,3
1000000US210670008011002,210670008011002,"Block 1002, Block Group 1, Census Tract 8.01, Fayette County, Kentucky",0,0,0
1000000US210670008011003,210670008011003,"Block 1003, Block Group 1, Census Tract 8.01, Fayette County, Kentucky",0,0,0
1000000US210670008011004,210670008011004,"Block 1004, Block Group 1, Census Tract 8.01, Fayette County, Kentucky",0,0,0
1000000US210670008011005,210670008011005,"Block 1005, Block Group 1, Census Tract 8.01, Fayette County, Kentucky",0,0,0
1000000US210670008011006,210670008011006,"Block 1006, Block Group 1, Census Tract 8.01, Fayette County, Kentucky",0,0,0
1000000US210670008011007,210670008011007,"Block 1007, Block Group 1, Census Tract 8.01, Fayette County, Kentucky",0,0,0
1000000US210670008011008,210670008011008,"Block 1008, Block Group 1, Census Tract 8.01, Fayette County, Kentucky",0,0,0
1000000US210670008021000,210670008021000,"Block 1000, Block Group 1, Census Tract 8.02, Fayette County, Kentucky",81,72,9
1000000US210670008021001,210670008021001,"Block 1001, Block Group 1, Census Tract 8.02, Fayette County, Kentucky",0,0,0
1000000US210670008021002,210670008021002,"Block 1002, Block Group 1, Census Tract 8.02, Fayette County, Kentucky",67,63,4
1000000US210670008021003,210670008021003,"Block 1003, Block Group 1, Census Tract 8.02, Fayette County, Kentucky",164,139,25
1000000US210670008021004,210670008021004,"Block 1004, Block Group 1, Census Tract 8.02, Fayette County, Kentucky",20,19,1
1000000US210670008021005,210670008021005,"Block 1005, Block Group 1, Census Tract 8.02, Fayette County, Kentucky",1,1,0
1000000US210670008021006,210670008021006,"Block 1006, Block Group 1, Census Tract 8.02, Fayette County, Kentucky",0,0,0
1000000US210670008021007,210670008021007,"Block 1007, Block Group 1, Census Tract 8.02, Fayette County, Kentucky",96,94,2
1000000US210670008021008,210670008021008,"Block 1008, Block Group 1, Census Tract 8.02, Fayette County, Kentucky",118,110,8
1000000US210670008021009,210670008021009,"Block 1009, Block Group 1, Census Tract 8.02, Fayette County, Kentucky",81,73,8
1000000US210670008021010,210670008021010,"Block 1010, Block Group 1, Census Tract 8.02, Fayette County, Kentucky",95,91,4
1000000US210670008021011,210670008021011,"Block 1011, Block Group 1, Census Tract 8.02, Fayette County, Kentucky",2,2,0
1000000US210670008021012,210670008021012,"Block 1012, Block Group 1, Census Tract 8.02, Fayette County, Kentucky",3,3,0
1000000US210670008022000,210670008022000,"Block 2000, Block Group 2, Census Tract 8.02, Fayette County, Kentucky",76,71,5
1000000US210670008022001,210670008022001,"Block 2001, Block Group 2, Census Tract 8.02, Fayette County, Kentucky",68,65,3
1000000US210670008022002,210670008022002,"Block 2002, Block Group 2, Census Tract 8.02, Fayette County, Kentucky",53,45,8
1000000US210670008022003,210670008022003,"Block 2003, Block Group 2, Census Tract 8.02, Fayette County, Kentucky",14,11,3
1000000US210670008022004,210670008022004,"Block 2004, Block Group 2, Census Tract 8.02, Fayette County, Kentucky",0,0,0
1000000US210670008022005,210670008022005,"Block 2005, Block Group 2, Census Tract 8.02, Fayette County, Kentucky",0,0,0
1000000US210670008022006,210670008022006,"Block 2006, Block Group 2, Census Tract 8.02, Fayette County, Kentucky",133,113,20
1000000US210670008022007,210670008022007,"Block 2007, Block Group 2, Census Tract 8.02, Fayette County, Kentucky",106,93,13
1000000US210670008022008,210670008022008,"Block 2008, Block Group 2, Census Tract 8.02, Fayette County, Kentucky",0,0,0
1000000US210670008022009,210670008022009,"Block 2009, Block Group 2, Census Tract 8.02, Fayette County, Kentucky",0,0,0
1000000US210670008022010,210670008022010,"Block 2010, Block Group 2, Census Tract 8.02, Fayette County, Kentucky",0,0,0
1000000US210670009001000,210670009001000,"Block 1000, Block Group 1, Census Tract 9, Fayette County, Kentucky",12,12,0
1000000US210670009001001,210670009001001,"Block 1001, Block Group 1, Census Tract 9, Fayette County, Kentucky",9,9,0
1000000US210670009001002,210670009001002,"Block 1002, Block Group 1, Census Tract 9, Fayette County, Kentucky",7,6,1
1000000US210670009001003,210670009001003,"Block 1003, Block Group 1, Census Tract 9, Fayette County, Kentucky",8,7,1
1000000US210670009001004,210670009001004,"Block 1004, Block Group 1, Census Tract 9, Fayette County, Kentucky",0,0,0
1000000US210670009001005,210670009001005,"Block 1005, Block Group 1, Census Tract 9, Fayette County, Kentucky",0,0,0
1000000US210670009001006,210670009001006,"Block 1006, Block Group 1, Census Tract 9, Fayette County, Kentucky",10,7,3
1000000US210670009001007,210670009001007,"Block 1007, Block Group 1, Census Tract 9, Fayette County, Kentucky",0,0,0
1000000US210670009001008,210670009001008,"Block 1008, Block Group 1, Census Tract 9, Fayette County, Kentucky",12,11,1
1000000US210670009001009,210670009001009,"Block 1009, Block Group 1, Census Tract 9, Fayette County, Kentucky",9,8,1
1000000US210670009001010,210670009001010,"Block 1010, Block Group 1, Census Tract 9, Fayette County, Kentucky",52,47,5
1000000US210670009001011,210670009001011,"Block 1011, Block Group 1, Census Tract 9, Fayette County, Kentucky",0,0,0
1000000US210670009001012,210670009001012,"Block 1012, Block Group 1, Census Tract 9, Fayette County, Kentucky",15,11,4
1000000US210670009001013,210670009001013,"Block 1013, Block Group 1, Census Tract 9, Fayette County, Kentucky",24,19,5
1000000US210670009001014,210670009001014,"Block 1014, Block Group 1, Census Tract 9, Fayette County, Kentucky",0,0,0
1000000US210670009001015,210670009001015,"Block 1015, Block Group 1, Census Tract 9, Fayette County, Kentucky",6,5,1
1000000US210670009001016,210670009001016,"Block 1016, Block Group 1, Census Tract 9, Fayette County, Kentucky",17,15,2
1000000US210670009001017,210670009001017,"Block 1017, Block Group 1, Census Tract 9, Fayette County, Kentucky",26,15,11
1000000US210670009001018,210670009001018,"Block 1018, Block Group 1, Census Tract 9, Fayette County, Kentucky",21,17,4
1000000US210670009001019,210670009001019,"Block 1019, Block Group 1, Census Tract 9, Fayette County, Kentucky",6,5,1
1000000US210670009001020,210670009001020,"Block 1020, Block Group 1, Census Tract 9, Fayette County, Kentucky",14,12,2
1000000US210670009001021,210670009001021,"Block 1021, Block Group 1, Census Tract 9, Fayette County, Kentucky",7,5,2
1000000US210670009001022,210670009001022,"Block 1022, Block Group 1, Census Tract 9, Fayette County, Kentucky",0,0,0
1000000US210670009001023,210670009001023,"Block 1023, Block Group 1, Census Tract 9, Fayette County, Kentucky",0,0,0
1000000US210670009001024,210670009001024,"Block 1024, Block Group 1, Census Tract 9, Fayette County, Kentucky",10,9,1
1000000US210670009001025,210670009001025,"Block 1025, Block Group 1, Census Tract 9, Fayette County, Kentucky",0,0,0
1000000US210670009001026,210670009001026,"Block 1026, Block Group 1, Census Tract 9, Fayette County, Kentucky",10,5,5
1000000US210670009001027,210670009001027,"Block 1027, Block Group 1, Census Tract 9, Fayette County, Kentucky",0,0,0
1000000US210670009001028,210670009001028,"Block 1028, Block Group 1, Census Tract 9, Fayette County, Kentucky",8,6,2
1000000US210670009001029,210670009001029,"Block 1029, Block Group 1, Census Tract 9, Fayette County, Kentucky",0,0,0
1000000US210670009001030,210670009001030,"Block 1030, Block Group 1, Census Tract 9, Fayette County, Kentucky",0,0,0
1000000US210670009001031,210670009001031,"Block 1031, Block Group 1, Census Tract 9, Fayette County, Kentucky",0,0,0
1000000US210670009001032,210670009001032,"Block 1032, Block Group 1, Census Tract 9, Fayette County, Kentucky",0,0,0
1000000US210670009001033,210670009001033,"Block 1033, Block Group 1, Census Tract 9, Fayette County, Kentucky",0,0,0
1000000US210670009001034,210670009001034,"Block 1034, Block Group 1, Census Tract 9, Fayette County, Kentucky",10,9,1
1000000US210670009001035,210670009001035,"Block 1035, Block Group 1, Census Tract 9, Fayette County, Kentucky",3,1,2
1000000US210670009001036,210670009001036,"Block 1036, Block Group 1, Census Tract 9, Fayette County, Kentucky",2,2,0
1000000US210670009002000,210670009002000,"Block 2000, Block Group 2, Census Tract 9, Fayette County, Kentucky",1,1,0
1000000US210670009002001,210670009002001,"Block 2001, Block Group 2, Census Tract 9, Fayette County, Kentucky",281,277,4
1000000US210670009002002,210670009002002,"Block 2002, Block Group 2, Census Tract 9, Fayette County, Kentucky",3,3,0
1000000US210670009002003,210670009002003,"Block 2003, Block Group 2, Census Tract 9, Fayette County, Kentucky",33,31,2
1000000US210670009002004,210670009002004,"Block 2004, Block Group 2, Census Tract 9, Fayette County, Kentucky",0,0,0
1000000US210670009002005,210670009002005,"Block 2005, Block Group 2, Census Tract 9, Fayette County, Kentucky",18,16,2
1000000US210670009002006,210670009002006,"Block 2006, Block Group 2, Census Tract 9, Fayette County, Kentucky",62,55,7
1000000US210670009002007,210670009002007,"Block 2007, Block Group 2, Census Tract 9, Fayette County, Kentucky",20,18,2
1000000US210670009003000,210670009003000,"Block 3000, Block Group 3, Census Tract 9, Fayette County, Kentucky",19,16,3
1000000US210670009003001,210670009003001,"Block 3001, Block Group 3, Census Tract 9, Fayette County, Kentucky",2,2,0
1000000US210670009003002,210670009003002,"Block 3002, Block Group 3, Census Tract 9, Fayette County, Kentucky",0,0,0
1000000US210670009003003,210670009003003,"Block 3003, Block Group 3, Census Tract 9, Fayette County, Kentucky",1,1,0
1000000US210670009003004,210670009003004,"Block 3004, Block Group 3, Census Tract 9, Fayette County, Kentucky",0,0,0
1000000US210670009003005,210670009003005,"Block 3005, Block Group 3, Census Tract 9, Fayette County, Kentucky",0,0,0
1000000US210670009003006,210670009003006,"Block 3006, Block Group 3, Census Tract 9, Fayette County, Kentucky",0,0,0
1000000US210670009003007,210670009003007,"Block 3007, Block Group 3, Census Tract 9, Fayette County, Kentucky",27,21,6
1000000US210670009003008,210670009003008,"Block 3008, Block Group 3, Census Tract 9, Fayette County, Kentucky",147,143,4
1000000US210670009003009,210670009003009,"Block 3009, Block Group 3, Census Tract 9, Fayette County, Kentucky",11,4,7
1000000US210670009003010,210670009003010,"Block 3010, Block Group 3, Census Tract 9, Fayette County, Kentucky",58,54,4
1000000US210670009003011,210670009003011,"Block 3011, Block Group 3, Census Tract 9, Fayette County, Kentucky",199,188,11
1000000US210670010001000,210670010001000,"Block 1000, Block Group 1, Census Tract 10, Fayette County, Kentucky",0,0,0
1000000US210670010001001,210670010001001,"Block 1001, Block Group 1, Census Tract 10, Fayette County, Kentucky",3,2,1
1000000US210670010001002,210670010001002,"Block 1002, Block Group 1, Census Tract 10, Fayette County, Kentucky",0,0,0
1000000US210670010001003,210670010001003,"Block 1003, Block Group 1, Census Tract 10, Fayette County, Kentucky",0,0,0
1000000US210670010001004,210670010001004,"Block 1004, Block Group 1, Census Tract 10, Fayette County, Kentucky",0,0,0
1000000US210670010001005,210670010001005,"Block 1005, Block Group 1, Census Tract 10, Fayette County, Kentucky",0,0,0
1000000US210670010001006,210670010001006,"Block 1006, Block Group 1, Census Tract 10, Fayette County, Kentucky",6,6,0
1000000US210670010001007,210670010001007,"Block 1007, Block Group 1, Census Tract 10, Fayette County, Kentucky",14,11,3
1000000US210670010001008,210670010001008,"Block 1008, Block Group 1, Census Tract 10, Fayette County, Kentucky",22,19,3
1000000US210670010001009,210670010001009,"Block 1009, Block Group 1, Census Tract 10, Fayette County, Kentucky",49,46,3
1000000US210670010001010,210670010001010,"Block 1010, Block Group 1, Census Tract 10, Fayette County, Kentucky",0,0,0
1000000US210670010001011,210670010001011,"Block 1011, Block Group 1, Census Tract 10, Fayette County, Kentucky",0,0,0
1000000US210670010001012,210670010001012,"Block 1012, Block Group 1, Census Tract 10, Fayette County, Kentucky",6,6,0
1000000US210670010002000,210670010002000,"Block 2000, Block Group 2, Census Tract 10, Fayette County, Kentucky",28,27,1
1000000US210670010002001,210670010002001,"Block 2001, Block Group 2, Census Tract 10, Fayette County, Kentucky",45,41,4
1000000US210670010002002,210670010002002,"Block 2002, Block Group 2, Census Tract 10, Fayette County, Kentucky",46,43,3
1000000US210670010002003,210670010002003,"Block 2003, Block Group 2, Census Tract 10, Fayette County, Kentucky",37,34,3
1000000US210670010002004,210670010002004,"Block 2004, Block Group 2, Census Tract 10, Fayette County, Kentucky",13,12,1
1000000US210670010002005,210670010002005,"Block 2005, Block Group 2, Census Tract 10, Fayette County, Kentucky",0,0,0
1000000US210670010002006,210670010002006,"Block 2006, Block Group 2, Census Tract 10, Fayette County, Kentucky",0,0,0
1000000US210670010002007,210670010002007,"Block 2007, Block Group 2, Census Tract 10, Fayette County, Kentucky",0,0,0
1000000US210670010002008,210670010002008,"Block 2008, Block Group 2, Census Tract 10, Fayette County, Kentucky",0,0,0
1000000US210670010002009,210670010002009,"Block 2009, Block Group 2, Census Tract 10, Fayette County, Kentucky",0,0,0
1000000US210670010002010,210670010002010,"Block 2010, Block Group 2, Census Tract 10, Fayette County, Kentucky",10,8,2
1000000US210670010002011,210670010002011,"Block 2011, Block Group 2, Census Tract 10, Fayette County, Kentucky",62,51,11
1000000US210670010002012,210670010002012,"Block 2012, Block Group 2, Census Tract 10, Fayette County, Kentucky",26,24,2
1000000US210670010002013,210670010002013,"Block 2013, Block Group 2, Census Tract 10, Fayette County, Kentucky",15,12,3
1000000US210670010002014,210670010002014,"Block 2014, Block Group 2, Census Tract 10, Fayette County, Kentucky",28,23,5
1000000US210670010002015,210670010002015,"Block 2015, Block Group 2, Census Tract 10, Fayette County, Kentucky",30,28,2
1000000US210670011001000,210670011001000,"Block 1000, Block Group 1, Census Tract 11, Fayette County, Kentucky",127,118,9
1000000US210670011001001,210670011001001,"Block 1001, Block Group 1, Census Tract 11, Fayette County, Kentucky",23,23,0
1000000US210670011001002,210670011001002,"Block 1002, Block Group 1, Census Tract 11, Fayette County, Kentucky",26,23,3
1000000US210670011001003,210670011001003,"Block 1003, Block Group 1, Census Tract 11, Fayette County, Kentucky",44,42,2
1000000US210670011001004,210670011001004,"Block 1004, Block Group 1, Census Tract 11, Fayette County, Kentucky",10,9,1
1000000US210670011001005,210670011001005,"Block 1005, Block Group 1, Census Tract 11, Fayette County, Kentucky",78,71,7
1000000US210670011001006,210670011001006,"Block 1006, Block Group 1, Census Tract 11, Fayette County, Kentucky",37,35,2
1000000US210670011001007,210670011001007,"Block 1007, Block Group 1, Census Tract 11, Fayette County, Kentucky",12,9,3
1000000US210670011001008,210670011001008,"Block 1008, Block Group 1, Census Tract 11, Fayette County, Kentucky",8,6,2
1000000US210670011002000,210670011002000,"Block 2000, Block Group 2, Census Tract 11, Fayette County, Kentucky",21,18,3
1000000US210670011002001,210670011002001,"Block 2001, Block Group 2, Census Tract 11, Fayette County, Kentucky",160,139,21
1000000US210670011002002,210670011002002,"Block 2002, Block Group 2, Census Tract 11, Fayette County, Kentucky",15,11,4
1000000US210670011002003,210670011002003,"Block 2003, Block Group 2, Census Tract 11, Fayette County, Kentucky",47,41,6
1000000US210670011002004,210670011002004,"Block 2004, Block Group 2, Census Tract 11, Fayette County, Kentucky",48,39,9
1000000US210670011002005,210670011002005,"Block 2005, Block Group 2, Census Tract 11, Fayette County, Kentucky",83,67,16
1000000US210670011002006,210670011002006,"Block 2006, Block Group 2, Census Tract 11, Fayette County, Kentucky",63,55,8
1000000US210670011002007,210670011002007,"Block 2007, Block Group 2, Census Tract 11, Fayette County, Kentucky",68,60,8
1000000US210670011002008,210670011002008,"Block 2008, Block Group 2, Census Tract 11, Fayette County, Kentucky",49,38,11
1000000US210670011002009,210670011002009,"Block 2009, Block Group 2, Census Tract 11, Fayette County, Kentucky",42,28,14
1000000US210670011002010,210670011002010,"Block 2010, Block Group 2, Census Tract 11, Fayette County, Kentucky",36,26,10
1000000US210670011002011,210670011002011,"Block 2011, Block Group 2, Census Tract 11, Fayette County, Kentucky",25,20,5
1000000US210670011002012,210670011002012,"Block 2012, Block Group 2, Census Tract 11, Fayette County, Kentucky",33,25,8
1000000US210670011002013,210670011002013,"Block 2013, Block Group 2, Census Tract 11, Fayette County, Kentucky",19,16,3
1000000US210670011002014,210670011002014,"Block 2014, Block Group 2, Census Tract 11, Fayette County, Kentucky",43,32,11
1000000US210670011002015,210670011002015,"Block 2015, Block Group 2, Census Tract 11, Fayette County, Kentucky",33,23,10
1000000US210670011002016,210670011002016,"Block 2016, Block Group 2, Census Tract 11, Fayette County, Kentucky",1,1,0
1000000US210670011002017,210670011002017,"Block 2017, Block Group 2, Census Tract 11, Fayette County, Kentucky",7,7,0
1000000US210670011002018,210670011002018,"Block 2018, Block Group 2, Census Tract 11, Fayette County, Kentucky",0,0,0
1000000US210670011002019,210670011002019,"Block 2019, Block Group 2, Census Tract 11, Fayette County, Kentucky",0,0,0
1000000US210670011002020,210670011002020,"Block 2020, Block Group 2, Census Tract 11, Fayette County, Kentucky",0,0,0
1000000US210670011002021,210670011002021,"Block 2021, Block Group 2, Census Tract 11, Fayette County, Kentucky",0,0,0
1000000US210670011003000,210670011003000,"Block 3000, Block Group 3, Census Tract 11, Fayette County, Kentucky",367,347,20
1000000US210670011003001,210670011003001,"Block 3001, Block Group 3, Census Tract 11, Fayette County, Kentucky",0,0,0
1000000US210670011003002,210670011003002,"Block 3002, Block Group 3, Census Tract 11, Fayette County, Kentucky",17,11,6
1000000US210670011003003,210670011003003,"Block 3003, Block Group 3, Census Tract 11, Fayette County, Kentucky",17,9,8
1000000US210670011003004,210670011003004,"Block 3004, Block Group 3, Census Tract 11, Fayette County, Kentucky",51,40,11
1000000US210670011003005,210670011003005,"Block 3005, Block Group 3, Census Tract 11, Fayette County, Kentucky",24,13,11
1000000US210670011003006,210670011003006,"Block 3006, Block Group 3, Census Tract 11, Fayette County, Kentucky",13,13,0
1000000US210670011003007,210670011003007,"Block 3007, Block Group 3, Census Tract 11, Fayette County, Kentucky",31,27,4
1000000US210670011003008,210670011003008,"Block 3008, Block Group 3, Census Tract 11, Fayette County, Kentucky",19,18,1
1000000US210670011003009,210670011003009,"Block 3009, Block Group 3, Census Tract 11, Fayette County, Kentucky",40,37,3
1000000US210670011003010,210670011003010,"Block 3010, Block Group 3, Census Tract 11, Fayette County, Kentucky",40,40,0
1000000US210670011003011,210670011003011,"Block 3011, Block Group 3, Census Tract 11, Fayette County, Kentucky",36,36,0
1000000US210670011003012,210670011003012,"Block 3012, Block Group 3, Census Tract 11, Fayette County, Kentucky",10,9,1
1000000US210670011003013,210670011003013,"Block 3013, Block Group 3, Census Tract 11, Fayette County, Kentucky",16,13,3
1000000US210670011003014,210670011003014,"Block 3014, Block Group 3, Census Tract 11, Fayette County, Kentucky",17,17,0
1000000US210670011003015,210670011003015,"Block 3015, Block Group 3, Census Tract 11, Fayette County, Kentucky",26,26,0
1000000US210670011003016,210670011003016,"Block 3016, Block Group 3, Census Tract 11, Fayette County, Kentucky",25,23,2
1000000US210670011003017,210670011003017,"Block 3017, Block Group 3, Census Tract 11, Fayette County, Kentucky",20,20,0
1000000US210670011003018,210670011003018,"Block 3018, Block Group 3, Census Tract 11, Fayette County, Kentucky",24,24,0
1000000US210670011003019,210670011003019,"Block 3019, Block Group 3, Census Tract 11, Fayette County, Kentucky",22,20,2
1000000US210670011003020,210670011003020,"Block 3020, Block Group 3, Census Tract 11, Fayette County, Kentucky",24,21,3
1000000US210670011003021,210670011003021,"Block 3021, Block Group 3, Census Tract 11, Fayette County, Kentucky",46,45,1
1000000US210670011003022,210670011003022,"Block 3022, Block Group 3, Census Tract 11, Fayette County, Kentucky",13,13,0
1000000US210670011003023,210670011003023,"Block 3023, Block Group 3, Census Tract 11, Fayette County, Kentucky",33,33,0
1000000US210670011003024,210670011003024,"Block 3024, Block Group 3, Census Tract 11, Fayette County, Kentucky",123,89,34
1000000US210670012001000,210670012001000,"Block 1000, Block Group 1, Census Tract 12, Fayette County, Kentucky",0,0,0
1000000US210670012001001,210670012001001,"Block 1001, Block Group 1, Census Tract 12, Fayette County, Kentucky",0,0,0
1000000US210670012001002,210670012001002,"Block 1002, Block Group 1, Census Tract 12, Fayette County, Kentucky",0,0,0
1000000US210670013001000,210670013001000,"Block 1000, Block Group 1, Census Tract 13, Fayette County, Kentucky",18,16,2
1000000US210670013001001,210670013001001,"Block 1001, Block Group 1, Census Tract 13, Fayette County, Kentucky",0,0,0
1000000US210670013001002,210670013001002,"Block 1002, Block Group 1, Census Tract 13, Fayette County, Kentucky",15,15,0
1000000US210670013001003,210670013001003,"Block 1003, Block Group 1, Census Tract 13, Fayette County, Kentucky",147,138,9
1000000US210670013001004,210670013001004,"Block 1004, Block Group 1, Census Tract 13, Fayette County, Kentucky",133,129,4
1000000US210670013001005,210670013001005,"Block 1005, Block Group 1, Census Tract 13, Fayette County, Kentucky",40,39,1
1000000US210670013001006,210670013001006,"Block 1006, Block Group 1, Census Tract 13, Fayette County, Kentucky",49,46,3
1000000US210670013002000,210670013002000,"Block 2000, Block Group 2, Census Tract 13, Fayette County, Kentucky",47,45,2
1000000US210670013002001,210670013002001,"Block 2001, Block Group 2, Census Tract 13, Fayette County, Kentucky",54,51,3
1000000US210670013002002,210670013002002,"Block 2002, Block Group 2, Census Tract 13, Fayette County, Kentucky",22,21,1
1000000US210670013002003,210670013002003,"Block 2003, Block Group 2, Census Tract 13, Fayette County, Kentucky",36,32,4
1000000US210670013002004,210670013002004,"Block 2004, Block Group 2, Census Tract 13, Fayette County, Kentucky",44,41,3
1000000US210670013002005,210670013002005,"Block 2005, Block Group 2, Census Tract 13, Fayette County, Kentucky",32,28,4
1000000US210670013002006,210670013002006,"Block 2006, Block Group 2, Census Tract 13, Fayette County, Kentucky",84,81,3
1000000US210670013002007,210670013002007,"Block 2007, Block Group 2, Census Tract 13, Fayette County, Kentucky",20,18,2
1000000US210670013002008,210670013002008,"Block 2008, Block Group 2, Census Tract 13, Fayette County, Kentucky",0,0,0
1000000US210670013002009,210670013002009,"Block 2009, Block Group 2, Census Tract 13, Fayette County, Kentucky",0,0,0
1000000US210670013002010,210670013002010,"Block 2010, Block Group 2, Census Tract 13, Fayette County, Kentucky",2,2,0
1000000US210670013002011,210670013002011,"Block 2011, Block Group 2, Census Tract 13, Fayette County, Kentucky",141,124,17
1000000US210670013002012,210670013002012,"Block 2012, Block Group 2, Census Tract 13, Fayette County, Kentucky",1,1,0
1000000US210670013002013,210670013002013,"Block 2013, Block Group 2, Census Tract 13, Fayette County, Kentucky",0,0,0
1000000US210670013002014,210670013002014,"Block 2014, Block Group 2, Census Tract 13, Fayette County, Kentucky",6,6,0
1000000US210670014001000,210670014001000,"Block 1000, Block Group 1, Census Tract 14, Fayette County, Kentucky",140,131,9
1000000US210670014001001,210670014001001,"Block 1001, Block Group 1, Census Tract 14, Fayette County, Kentucky",17,17,0
1000000US210670014001002,210670014001002,"Block 1002, Block Group 1, Census Tract 14, Fayette County, Kentucky",15,14,1
1000000US210670014001003,210670014001003,"Block 1003, Block Group 1, Census Tract 14, Fayette County, Kentucky",10,10,0
1000000US210670014001004,210670014001004,"Block 1004, Block Group 1, Census Tract 14, Fayette County, Kentucky",8,7,1
1000000US210670014001005,210670014001005,"Block 1005, Block Group 1, Census Tract 14, Fayette County, Kentucky",10,10,0
1000000US210670014001006,210670014001006,"Block 1006, Block Group 1, Census Tract 14, Fayette County, Kentucky",7,7,0
1000000US210670014001007,210670014001007,"Block 1007, Block Group 1, Census Tract 14, Fayette County, Kentucky",3,3,0
1000000US210670014001008,210670014001008,"Block 1008, Block Group 1, Census Tract 14, Fayette County, Kentucky",3,2,1
1000000US210670014001009,210670014001009,"Block 1009, Block Group 1, Census Tract 14, Fayette County, Kentucky",58,55,3
1000000US210670014001010,210670014001010,"Block 1010, Block Group 1, Census Tract 14, Fayette County, Kentucky",40,35,5
1000000US210670014001011,210670014001011,"Block 1011, Block Group 1, Census Tract 14, Fayette County, Kentucky",0,0,0
1000000US210670014002000,210670014002000,"Block 2000, Block Group 2, Census Tract 14, Fayette County, Kentucky",5,5,0
1000000US210670014002001,210670014002001,"Block 2001, Block Group 2, Census Tract 14, Fayette County, Kentucky",4,2,2
1000000US210670014002002,210670014002002,"Block 2002, Block Group 2, Census Tract 14, Fayette County, Kentucky",6,5,1
1000000US210670014002003,210670014002003,"Block 2003, Block Group 2, Census Tract 14, Fayette County, Kentucky",8,8,0
1000000US210670014002004,210670014002004,"Block 2004, Block Group 2, Census Tract 14, Fayette County, Kentucky",7,6,1
1000000US210670014002005,210670014002005,"Block 2005, Block Group 2, Census Tract 14, Fayette County, Kentucky",8,8,0
1000000US210670014002006,210670014002006,"Block 2006, Block Group 2, Census Tract 14, Fayette County, Kentucky",12,11,1
1000000US210670014002007,210670014002007,"Block 2007, Block Group 2, Census Tract 14, Fayette County, Kentucky",12,10,2
1000000US210670014002008,210670014002008,"Block 2008, Block Group 2, Census Tract 14, Fayette County, Kentucky",15,10,5
1000000US210670014002009,210670014002009,"Block 2009, Block Group 2, Census Tract 14, Fayette County, Kentucky",20,19,1
1000000US210670014002010,210670014002010,"Block 2010, Block Group 2, Census Tract 14, Fayette County, Kentucky",6,4,2
1000000US210670014002011,210670014002011,"Block 2011, Block Group 2, Census Tract 14, Fayette County, Kentucky",9,9,0
1000000US210670014002012,210670014002012,"Block 2012, Block Group 2, Census Tract 14, Fayette County, Kentucky",10,9,1
1000000US210670014002013,210670014002013,"Block 2013, Block Group 2, Census Tract 14, Fayette County, Kentucky",6,4,2
1000000US210670014002014,210670014002014,"Block 2014, Block Group 2, Census Tract 14, Fayette County, Kentucky",51,42,9
1000000US210670014002015,210670014002015,"Block 2015, Block Group 2, Census Tract 14, Fayette County, Kentucky",47,46,1
1000000US210670014003000,210670014003000,"Block 3000, Block Group 3, Census Tract 14, Fayette County, Kentucky",48,47,1
1000000US210670014003001,210670014003001,"Block 3001, Block Group 3, Census Tract 14, Fayette County, Kentucky",36,28,8
1000000US210670014003002,210670014003002,"Block 3002, Block Group 3, Census Tract 14, Fayette County, Kentucky",45,36,9
1000000US210670014003003,210670014003003,"Block 3003, Block Group 3, Census Tract 14, Fayette County, Kentucky",68,61,7
1000000US210670014003004,210670014003004,"Block 3004, Block Group 3, Census Tract 14, Fayette County, Kentucky",44,42,2
1000000US210670014003005,210670014003005,"Block 3005, Block Group 3, Census Tract 14, Fayette County, Kentucky",53,47,6
1000000US210670014003006,210670014003006,"Block 3006, Block Group 3, Census Tract 14, Fayette County, Kentucky",55,48,7
1000000US210670014004000,210670014004000,"Block 4000, Block Group 4, Census Tract 14, Fayette County, Kentucky",12,11,1
1000000US210670014004001,210670014004001,"Block 4001, Block Group 4, Census Tract 14, Fayette County, Kentucky",41,35,6
1000000US210670014004002,210670014004002,"Block 4002, Block Group 4, Census Tract 14, Fayette County, Kentucky",13,12,1
1000000US210670014004003,210670014004003,"Block 4003, Block Group 4, Census Tract 14, Fayette County, Kentucky",44,38,6
1000000US210670014004004,210670014004004,"Block 4004, Block Group 4, Census Tract 14, Fayette County, Kentucky",1,1,0
1000000US210670014004005,210670014004005,"Block 4005, Block Group 4, Census Tract 14, Fayette County, Kentucky",81,74,7
1000000US210670014004006,210670014004006,"Block 4006, Block Group 4, Census Tract 14, Fayette County, Kentucky",41,39,2
1000000US210670014004007,210670014004007,"Block 4007, Block Group 4, Census Tract 14, Fayette County, Kentucky",16,15,1
1000000US210670014004008,210670014004008,"Block 4008, Block Group 4, Census Tract 14, Fayette County, Kentucky",37,36,1
1000000US210670015001000,210670015001000,"Block 1000, Block Group 1, Census Tract 15, Fayette County, Kentucky",40,40,0
1000000US210670015001001,210670015001001,"Block 1001, Block Group 1, Census Tract 15, Fayette County, Kentucky",88,86,2
1000000US210670015001002,210670015001002,"Block 1002, Block Group 1, Census Tract 15, Fayette County, Kentucky",34,34,0
1000000US210670015001003,210670015001003,"Block 1003, Block Group 1, Census Tract 15, Fayette County, Kentucky",53,52,1
1000000US210670015001004,210670015001004,"Block 1004, Block Group 1, Census Tract 15, Fayette County, Kentucky",44,40,4
1000000US210670015001005,210670015001005,"Block 1005, Block Group 1, Census Tract 15, Fayette County, Kentucky",86,82,4
1000000US210670015001006,210670015001006,"Block 1006, Block Group 1, Census Tract 15, Fayette County, Kentucky",46,46,0
1000000US210670015002000,210670015002000,"Block 2000, Block Group 2, Census Tract 15, Fayette County, Kentucky",142,135,7
1000000US210670015002001,210670015002001,"Block 2001, Block Group 2, Census Tract 15, Fayette County, Kentucky",0,0,0
1000000US210670015002002,210670015002002,"Block 2002, Block Group 2, Census Tract 15, Fayette County, Kentucky",46,41,5
1000000US210670015002003,210670015002003,"Block 2003, Block Group 2, Census Tract 15, Fayette County, Kentucky",89,87,2
1000000US210670015002004,210670015002004,"Block 2004, Block Group 2, Census Tract 15, Fayette County, Kentucky",27,26,1
1000000US210670015002005,210670015002005,"Block 2005, Block Group 2, Census Tract 15, Fayette County, Kentucky",32,31,1
1000000US210670015002006,210670015002006,"Block 2006, Block Group 2, Census Tract 15, Fayette County, Kentucky",55,54,1
1000000US210670015002007,210670015002007,"Block 2007, Block Group 2, Census Tract 15, Fayette County, Kentucky",49,45,4
1000000US210670015003000,210670015003000,"Block 3000, Block Group 3, Census Tract 15, Fayette County, Kentucky",0,0,0
1000000US210670015003001,210670015003001,"Block 3001, Block Group 3, Census Tract 15, Fayette County, Kentucky",0,0,0
1000000US210670015003002,210670015003002,"Block 3002, Block Group 3, Census Tract 15, Fayette County, Kentucky",0,0,0
1000000US210670015003003,210670015003003,"Block 3003, Block Group 3, Census Tract 15, Fayette County, Kentucky",3,3,0
1000000US210670015003004,210670015003004,"Block 3004, Block Group 3, Census Tract 15, Fayette County, Kentucky",0,0,0
1000000US210670015003005,210670015003005,"Block 3005, Block Group 3, Census Tract 15, Fayette County, Kentucky",0,0,0
1000000US210670015003006,210670015003006,"Block 3006, Block Group 3, Census Tract 15, Fayette County, Kentucky",3,3,0
1000000US210670015003007,210670015003007,"Block 3007, Block Group 3, Census Tract 15, Fayette County, Kentucky",0,0,0
1000000US210670015003008,210670015003008,"Block 3008, Block Group 3, Census Tract 15, Fayette County, Kentucky",73,73,0
1000000US210670015003009,210670015003009,"Block 3009, Block Group 3, Census Tract 15, Fayette County, Kentucky",0,0,0
1000000US210670016001000,210670016001000,"Block 1000, Block Group 1, Census Tract 16, Fayette County, Kentucky",544,510,34
1000000US210670016001001,210670016001001,"Block 1001, Block Group 1, Census Tract 16, Fayette County, Kentucky",0,0,0
1000000US210670016001002,210670016001002,"Block 1002, Block Group 1, Census Tract 16, Fayette County, Kentucky",31,30,1
1000000US210670016001003,210670016001003,"Block 1003, Block Group 1, Census Tract 16, Fayette County, Kentucky",60,55,5
1000000US210670016001004,210670016001004,"Block 1004, Block Group 1, Census Tract 16, Fayette County, Kentucky",65,63,2
1000000US210670016001005,210670016001005,"Block 1005, Block Group 1, Census Tract 16, Fayette County, Kentucky",35,34,1
1000000US210670016001006,210670016001006,"Block 1006, Block Group 1, Census Tract 16, Fayette County, Kentucky",36,35,1
1000000US210670016001007,210670016001007,"Block 1007, Block Group 1, Census Tract 16, Fayette County, Kentucky",13,13,0
1000000US210670016002000,210670016002000,"Block 2000, Block Group 2, Census Tract 16, Fayette County, Kentucky",0,0,0
1000000US210670016002001,210670016002001,"Block 2001, Block Group 2, Census Tract 16, Fayette County, Kentucky",4,4,0
1000000US210670016002002,210670016002002,"Block 2002, Block Group 2, Census Tract 16, Fayette County, Kentucky",9,9,0
1000000US210670016002003,210670016002003,"Block 2003, Block Group 2, Census Tract 16, Fayette County, Kentucky",29,29,0
1000000US210670016002004,210670016002004,"Block 2004, Block Group 2, Census Tract 16, Fayette County, Kentucky",64,58,6
1000000US210670016002005,210670016002005,"Block 2005, Block Group 2, Census Tract 16, Fayette County, Kentucky",26,24,2
1000000US210670016002006,210670016002006,"Block 2006, Block Group 2, Census Tract 16, Fayette County, Kentucky",1,1,0
1000000US210670016002007,210670016002007,"Block 2007, Block Group 2, Census Tract 16, Fayette County, Kentucky",53,52,1
1000000US210670016002008,210670016002008,"Block 2008, Block Group 2, Census Tract 16, Fayette County, Kentucky",27,24,3
1000000US210670016002009,210670016002009,"Block 2009, Block Group 2, Census Tract 16, Fayette County, Kentucky",26,23,3
1000000US210670016002010,210670016002010,"Block 2010, Block Group 2, Census Tract 16, Fayette County, Kentucky",37,34,3
1000000US210670016002011,210670016002011,"Block 2011, Block Group 2, Census Tract 16, Fayette County, Kentucky",53,52,1
1000000US210670016002012,210670016002012,"Block 2012, Block Group 2, Census Tract 16, Fayette County, Kentucky",14,13,1
1000000US210670016002013,210670016002013,"Block 2013, Block Group 2, Census Tract 16, Fayette County, Kentucky",1,1,0
1000000US210670016002014,210670016002014,"Block 2014, Block Group 2, Census Tract 16, Fayette County, Kentucky",0,0,0
1000000US210670016002015,210670016002015,"Block 2015, Block Group 2, Census Tract 16, Fayette County, Kentucky",0,0,0
1000000US210670016002016,210670016002016,"Block 2016, Block Group 2, Census Tract 16, Fayette County, Kentucky",19,19,0
1000000US210670016002017,210670016002017,"Block 2017, Block Group 2, Census Tract 16, Fayette County, Kentucky",23,21,2
1000000US210670016002018,210670016002018,"Block 2018, Block Group 2, Census Tract 16, Fayette County, Kentucky",29,28,1
1000000US210670017001000,210670017001000,"Block 1000, Block Group 1, Census Tract 17, Fayette County, Kentucky",47,47,0
1000000US210670017001001,210670017001001,"Block 1001, Block Group 1, Census Tract 17, Fayette County, Kentucky",51,49,2
1000000US210670017001002,210670017001002,"Block 1002, Block Group 1, Census Tract 17, Fayette County, Kentucky",47,45,2
1000000US210670017001003,210670017001003,"Block 1003, Block Group 1, Census Tract 17, Fayette County, Kentucky",50,49,1
1000000US210670017001004,210670017001004,"Block 1004, Block Group 1, Census Tract 17, Fayette County, Kentucky",30,30,0
1000000US210670017001005,210670017001005,"Block 1005, Block Group 1, Census Tract 17, Fayette County, Kentucky",16,15,1
1000000US210670017001006,210670017001006,"Block 1006, Block Group 1, Census Tract 17, Fayette County, Kentucky",20,19,1
1000000US210670017001007,210670017001007,"Block 1007, Block Group 1, Census Tract 17, Fayette County, Kentucky",19,19,0
1000000US210670017001008,210670017001008,"Block 1008, Block Group 1, Census Tract 17, Fayette County, Kentucky",16,15,1
1000000US210670017002000,210670017002000,"Block 2000, Block Group 2, Census Tract 17, Fayette County, Kentucky",137,130,7
1000000US210670017002001,210670017002001,"Block 2001, Block Group 2, Census Tract 17, Fayette County, Kentucky",87,83,4
1000000US210670017002002,210670017002002,"Block 2002, Block Group 2, Census Tract 17, Fayette County, Kentucky",40,35,5
1000000US210670017002003,210670017002003,"Block 2003, Block Group 2, Census Tract 17, Fayette County, Kentucky",80,77,3
1000000US210670017002004,210670017002004,"Block 2004, Block Group 2, Census Tract 17, Fayette County, Kentucky",58,56,2
1000000US210670017002005,210670017002005,"Block 2005, Block Group 2, Census Tract 17, Fayette County, Kentucky",0,0,0
1000000US210670017003000,210670017003000,"Block 3000, Block Group 3, Census Tract 17, Fayette County, Kentucky",127,112,15
1000000US210670017003001,210670017003001,"Block 3001, Block Group 3, Census Tract 17, Fayette County, Kentucky",42,40,2
1000000US210670017003002,210670017003002,"Block 3002, Block Group 3, Census Tract 17, Fayette County, Kentucky",60,60,0
1000000US210670017003003,210670017003003,"Block 3003, Block Group 3, Census Tract 17, Fayette County, Kentucky",63,60,3
1000000US210670017003004,210670017003004,"Block 3004, Block Group 3, Census Tract 17, Fayette County, Kentucky",58,58,0
1000000US210670017003005,210670017003005,"Block 3005, Block Group 3, Census Tract 17, Fayette County, Kentucky",54,53,1
1000000US210670017003006,210670017003006,"Block 3006, Block Group 3, Census Tract 17, Fayette County, Kentucky",51,47,4
1000000US210670018001000,210670018001000,"Block 1000, Block Group 1, Census Tract 18, Fayette County, Kentucky",22,22,0
1000000US210670018001001,210670018001001,"Block 1001, Block Group 1, Census Tract 18, Fayette County, Kentucky",124,118,6
1000000US210670018001002,210670018001002,"Block 1002, Block Group 1, Census Tract 18, Fayette County, Kentucky",26,22,4
1000000US210670018001003,210670018001003,"Block 1003, Block Group 1, Census Tract 18, Fayette County, Kentucky",153,150,3
1000000US210670018001004,210670018001004,"Block 1004, Block Group 1, Census Tract 18, Fayette County, Kentucky",105,99,6
1000000US210670018001005,210670018001005,"Block 1005, Block Group 1, Census Tract 18, Fayette County, Kentucky",67,64,3
1000000US210670018001006,210670018001006,"Block 1006, Block Group 1, Census Tract 18, Fayette County, Kentucky",71,65,6
1000000US210670018001007,210670018001007,"Block 1007, Block Group 1, Census Tract 18, Fayette County, Kentucky",28,28,0
1000000US210670018001008,210670018001008,"Block 1008, Block Group 1, Census Tract 18, Fayette County, Kentucky",30,27,3
1000000US210670018001009,210670018001009,"Block 1009, Block Group 1, Census Tract 18, Fayette County, Kentucky",37,30,7
1000000US210670018001010,210670018001010,"Block 1010, Block Group 1, Census Tract 18, Fayette County, Kentucky",35,33,2
1000000US210670018002000,210670018002000,"Block 2000, Block Group 2, Census Tract 18, Fayette County, Kentucky",0,0,0
1000000US210670018002001,210670018002001,"Block 2001, Block Group 2, Census Tract 18, Fayette County, Kentucky",417,383,34
1000000US210670018002002,210670018002002,"Block 2002, Block Group 2, Census Tract 18, Fayette County, Kentucky",11,11,0
1000000US210670018002003,210670018002003,"Block 2003, Block Group 2, Census Tract 18, Fayette County, Kentucky",14,13,1
1000000US210670018002004,210670018002004,"Block 2004, Block Group 2, Census Tract 18, Fayette County, Kentucky",39,38,1
1000000US210670018003000,210670018003000,"Block 3000, Block Group 3, Census Tract 18, Fayette County, Kentucky",0,0,0
1000000US210670018003001,210670018003001,"Block 3001, Block Group 3, Census Tract 18, Fayette County, Kentucky",4,4,0
1000000US210670018003002,210670018003002,"Block 3002, Block Group 3, Census Tract 18, Fayette County, Kentucky",8,7,1
1000000US210670018003003,210670018003003,"Block 3003, Block Group 3, Census Tract 18, Fayette County, Kentucky",111,94,17
1000000US210670018003004,210670018003004,"Block 3004, Block Group 3, Census Tract 18, Fayette County, Kentucky",14,12,2
1000000US210670018003005,210670018003005,"Block 3005, Block Group 3, Census Tract 18, Fayette County, Kentucky",2,2,0
1000000US210670018003006,210670018003006,"Block 3006, Block Group 3, Census Tract 18, Fayette County, Kentucky",150,143,7
1000000US210670018003007,210670018003007,"Block 3007, Block Group 3, Census Tract 18, Fayette County, Kentucky",0,0,0
1000000US210670019001000,210670019001000,"Block 1000, Block Group 1, Census Tract 19, Fayette County, Kentucky",29,26,3
1000000US210670019001001,210670019001001,"Block 1001, Block Group 1, Census Tract 19, Fayette County, Kentucky",1239,1151,88
1000000US210670019001002,210670019001002,"Block 1002, Block Group 1, Census Tract 19, Fayette County, Kentucky",16,16,0
1000000US210670019001003,210670019001003,"Block 1003, Block Group 1, Census Tract 19, Fayette County, Kentucky",14,13,1
1000000US210670019001004,210670019001004,"Block 1004, Block Group 1, Census Tract 19, Fayette County, Kentucky",20,19,1
1000000US210670019001005,210670019001005,"Block 1005, Block Group 1, Census Tract 19, Fayette County, Kentucky",29,29,0
1000000US210670019001006,210670019001006,"Block 1006, Block Group 1, Census Tract 19, Fayette County, Kentucky",5,5,0
1000000US210670019001007,210670019001007,"Block 1007, Block Group 1, Census Tract 19, Fayette County, Kentucky",57,51,6
1000000US210670019001008,210670019001008,"Block 1008, Block Group 1, Census Tract 19, Fayette County, Kentucky",28,28,0
1000000US210670019001009,210670019001009,"Block 1009, Block Group 1, Census Tract 19, Fayette County, Kentucky",29,27,2
1000000US210670019001010,210670019001010,"Block 1010, Block Group 1, Census Tract 19, Fayette County, Kentucky",32,32,0
1000000US210670019001011,210670019001011,"Block 1011, Block Group 1, Census Tract 19, Fayette County, Kentucky",25,25,0
1000000US210670019001012,210670019001012,"Block 1012, Block Group 1, Census Tract 19, Fayette County, Kentucky",9,9,0
1000000US210670019001013,210670019001013,"Block 1013, Block Group 1, Census Tract 19, Fayette County, Kentucky",0,0,0
1000000US210670019001014,210670019001014,"Block 1014, Block Group 1, Census Tract 19, Fayette County, Kentucky",186,169,17
1000000US210670019001015,210670019001015,"Block 1015, Block Group 1, Census Tract 19, Fayette County, Kentucky",12,12,0
1000000US210670019001016,210670019001016,"Block 1016, Block Group 1, Census Tract 19, Fayette County, Kentucky",26,26,0
1000000US210670020001000,210670020001000,"Block 1000, Block Group 1, Census Tract 20, Fayette County, Kentucky",17,16,1
1000000US210670020001001,210670020001001,"Block 1001, Block Group 1, Census Tract 20, Fayette County, Kentucky",250,238,12
1000000US210670020001002,210670020001002,"Block 1002, Block Group 1, Census Tract 20, Fayette County, Kentucky",34,34,0
1000000US210670020001003,210670020001003,"Block 1003, Block Group 1, Census Tract 20, Fayette County, Kentucky",36,36,0
1000000US210670020001004,210670020001004,"Block 1004, Block Group 1, Census Tract 20, Fayette County, Kentucky",31,30,1
1000000US210670020001005,210670020001005,"Block 1005, Block Group 1, Census Tract 20, Fayette County, Kentucky",33,31,2
1000000US210670020001006,210670020001006,"Block 1006, Block Group 1, Census Tract 20, Fayette County, Kentucky",28,27,1
1000000US210670020001007,210670020001007,"Block 1007, Block Group 1, Census Tract 20, Fayette County, Kentucky",48,44,4
1000000US210670020001008,210670020001008,"Block 1008, Block Group 1, Census Tract 20, Fayette County, Kentucky",53,51,2
1000000US210670020001009,210670020001009,"Block 1009, Block Group 1, Census Tract 20, Fayette County, Kentucky",230,221,9
1000000US210670020001010,210670020001010,"Block 1010, Block Group 1, Census Tract 20, Fayette County, Kentucky",32,30,2
1000000US210670020001011,210670020001011,"Block 1011, Block Group 1, Census Tract 20, Fayette County, Kentucky",182,170,12
1000000US210670020001012,210670020001012,"Block 1012, Block Group 1, Census Tract 20, Fayette County, Kentucky",211,200,11
1000000US210670020002000,210670020002000,"Block 2000, Block Group 2, Census Tract 20, Fayette County, Kentucky",53,52,1
1000000US210670020002001,210670020002001,"Block 2001, Block Group 2, Census Tract 20, Fayette County, Kentucky",37,37,0
1000000US210670020002002,210670020002002,"Block 2002, Block Group 2, Census Tract 20, Fayette County, Kentucky",29,29,0
1000000US210670020002003,210670020002003,"Block 2003, Block Group 2, Census Tract 20, Fayette County, Kentucky",48,45,3
1000000US210670020002004,210670020002004,"Block 2004, Block Group 2, Census Tract 20, Fayette County, Kentucky",13,13,0
1000000US210670020002005,210670020002005,"Block 2005, Block Group 2, Census Tract 20, Fayette County, Kentucky",108,104,4
1000000US210670020002006,210670020002006,"Block 2006, Block Group 2, Census Tract 20, Fayette County, Kentucky",38,31,7
1000000US210670020002007,210670020002007,"Block 2007, Block Group 2, Census Tract 20, Fayette County, Kentucky",448,400,48
1000000US210670020002008,210670020002008,"Block 2008, Block Group 2, Census Tract 20, Fayette County, Kentucky",342,311,31
1000000US210670020002009,210670020002009,"Block 2009, Block Group 2, Census Tract 20, Fayette County, Kentucky",32,29,3
1000000US210670020002010,210670020002010,"Block 2010, Block Group 2, Census Tract 20, Fayette County, Kentucky",41,41,0
1000000US210670020002011,210670020002011,"Block 2011, Block Group 2, Census Tract 20, Fayette County, Kentucky",47,46,1
1000000US210670020002012,210670020002012,"Block 2012, Block Group 2, Census Tract 20, Fayette County, Kentucky",48,47,1
1000000US210670020002013,210670020002013,"Block 2013, Block Group 2, Census Tract 20, Fayette County, Kentucky",50,46,4
1000000US210670020002014,210670020002014,"Block 2014, Block Group 2, Census Tract 20, Fayette County, Kentucky",0,0,0
1000000US210670020002015,210670020002015,"Block 2015, Block Group 2, Census Tract 20, Fayette County, Kentucky",153,149,4
1000000US210670020002016,210670020002016,"Block 2016, Block Group 2, Census Tract 20, Fayette County, Kentucky",0,0,0
1000000US210670020002017,210670020002017,"Block 2017, Block Group 2, Census Tract 20, Fayette County, Kentucky",2,2,0
1000000US210670020002018,210670020002018,"Block 2018, Block Group 2, Census Tract 20, Fayette County, Kentucky",152,138,14
1000000US210670020003000,210670020003000,"Block 3000, Block Group 3, Census Tract 20, Fayette County, Kentucky",0,0,0
1000000US210670020003001,210670020003001,"Block 3001, Block Group 3, Census Tract 20, Fayette County, Kentucky",89,87,2
1000000US210670020003002,210670020003002,"Block 3002, Block Group 3, Census Tract 20, Fayette County, Kentucky",25,24,1
1000000US210670020003003,210670020003003,"Block 3003, Block Group 3, Census Tract 20, Fayette County, Kentucky",40,39,1
1000000US210670020003004,210670020003004,"Block 3004, Block Group 3, Census Tract 20, Fayette County, Kentucky",1,1,0
1000000US210670020003005,210670020003005,"Block 3005, Block Group 3, Census Tract 20, Fayette County, Kentucky",37,37,0
1000000US210670020003006,210670020003006,"Block 3006, Block Group 3, Census Tract 20, Fayette County, Kentucky",14,9,5
1000000US210670020003007,210670020003007,"Block 3007, Block Group 3, Census Tract 20, Fayette County, Kentucky",111,108,3
1000000US210670020003008,210670020003008,"Block 3008, Block Group 3, Census Tract 20, Fayette County, Kentucky",18,18,0
1000000US210670020003009,210670020003009,"Block 3009, Block Group 3, Census Tract 20, Fayette County, Kentucky",19,18,1
1000000US210670020003010,210670020003010,"Block 3010, Block Group 3, Census Tract 20, Fayette County, Kentucky",38,37,1
1000000US210670020003011,210670020003011,"Block 3011, Block Group 3, Census Tract 20, Fayette County, Kentucky",36,36,0
1000000US210670020003012,210670020003012,"Block 3012, Block Group 3, Census Tract 20, Fayette County, Kentucky",143,135,8
1000000US210670020003013,210670020003013,"Block 3013, Block Group 3, Census Tract 20, Fayette County, Kentucky",27,25,2
1000000US210670020003014,210670020003014,"Block 3014, Block Group 3, Census Tract 20, Fayette County, Kentucky",1,1,0
1000000US210670020003015,210670020003015,"Block 3015, Block Group 3, Census Tract 20, Fayette County, Kentucky",5,2,3
1000000US210670021001000,210670021001000,"Block 1000, Block Group 1, Census Tract 21, Fayette County, Kentucky",16,16,0
1000000US210670021001001,210670021001001,"Block 1001, Block Group 1, Census Tract 21, Fayette County, Kentucky",1,0,1
1000000US210670021001002,210670021001002,"Block 1002, Block Group 1, Census Tract 21, Fayette County, Kentucky",0,0,0
1000000US210670021001003,210670021001003,"Block 1003, Block Group 1, Census Tract 21, Fayette County, Kentucky",2,2,0
1000000US210670021001004,210670021001004,"Block 1004, Block Group 1, Census Tract 21, Fayette County, Kentucky",0,0,0
1000000US210670021001005,210670021001005,"Block 1005, Block Group 1, Census Tract 21, Fayette County, Kentucky",0,0,0
1000000US210670022001000,210670022001000,"Block 1000, Block Group 1, Census Tract 22, Fayette County, Kentucky",31,30,1
1000000US210670022001001,210670022001001,"Block 1001, Block Group 1, Census Tract 22, Fayette County, Kentucky",31,31,0
1000000US210670022001002,210670022001002,"Block 1002, Block Group 1, Census Tract 22, Fayette County, Kentucky",23,22,1
1000000US210670022001003,210670022001003,"Block 1003, Block Group 1, Census Tract 22, Fayette County, Kentucky",49,47,2
1000000US210670022001004,210670022001004,"Block 1004, Block Group 1, Census Tract 22, Fayette County, Kentucky",55,53,2
1000000US210670022001005,210670022001005,"Block 1005, Block Group 1, Census Tract 22, Fayette County, Kentucky",54,49,5
1000000US210670022001006,210670022001006,"Block 1006, Block Group 1, Census Tract 22, Fayette County, Kentucky",46,44,2
1000000US210670022001007,210670022001007,"Block 1007, Block Group 1, Census Tract 22, Fayette County, Kentucky",9,9,0
1000000US210670022001008,210670022001008,"Block 1008, Block Group 1, Census Tract 22, Fayette County, Kentucky",19,18,1
1000000US210670022001009,210670022001009,"Block 1009, Block Group 1, Census Tract 22, Fayette County, Kentucky",15,15,0
1000000US210670022001010,210670022001010,"Block 1010, Block Group 1, Census Tract 22, Fayette County, Kentucky",5,5,0
1000000US210670022002000,210670022002000,"Block 2000, Block Group 2, Census Tract 22, Fayette County, Kentucky",0,0,0
1000000US210670022002001,210670022002001,"Block 2001, Block Group 2, Census Tract 22, Fayette County, Kentucky",353,333,20
1000000US210670022002002,210670022002002,"Block 2002, Block Group 2, Census Tract 22, Fayette County, Kentucky",1,1,0
1000000US210670022002003,210670022002003,"Block 2003, Block Group 2, Census Tract 22, Fayette County, Kentucky",43,42,1
1000000US210670022002004,210670022002004,"Block 2004, Block Group 2, Census Tract 22, Fayette County, Kentucky",35,34,1
1000000US210670022002005,210670022002005,"Block 2005, Block Group 2, Census Tract 22, Fayette County, Kentucky",24,23,1
1000000US210670022002006,210670022002006,"Block 2006, Block Group 2, Census Tract 22, Fayette County, Kentucky",8,8,0
1000000US210670022002007,210670022002007,"Block 2007, Block Group 2, Census Tract 22, Fayette County, Kentucky",20,19,1
1000000US210670022002008,210670022002008,"Block 2008, Block Group 2, Census Tract 22, Fayette County, Kentucky",5,3,2
1000000US210670023011000,210670023011000,"Block 1000, Block Group 1, Census Tract 23.01, Fayette County, Kentucky",221,202,19
1000000US210670023011001,210670023011001,"Block 1001, Block Group 1, Census Tract 23.01, Fayette County, Kentucky",639,580,59
1000000US210670023011002,210670023011002,"Block 1002, Block Group 1, Census Tract 23.01, Fayette County, Kentucky",132,118,14
1000000US210670023011003,210670023011003,"Block 1003, Block Group 1, Census Tract 23.01, Fayette County, Kentucky",5,5,0
1000000US210670023011004,210670023011004,"Block 1004, Block Group 1, Census Tract 23.01, Fayette County, Kentucky",0,0,0
1000000US210670023011005,210670023011005,"Block 1005, Block Group 1, Census Tract 23.01, Fayette County, Kentucky",414,383,31
1000000US210670023011006,210670023011006,"Block 1006, Block Group 1, Census Tract 23.01, Fayette County, Kentucky",209,203,6
1000000US210670023011007,210670023011007,"Block 1007, Block Group 1, Census Tract 23.01, Fayette County, Kentucky",13,13,0
1000000US210670023011008,210670023011008,"Block 1008, Block Group 1, Census Tract 23.01, Fayette County, Kentucky",28,24,4
1000000US210670023011009,210670023011009,"Block 1009, Block Group 1, Census Tract 23.01, Fayette County, Kentucky",13,13,0
1000000US210670023011010,210670023011010,"Block 1010, Block Group 1, Census Tract 23.01, Fayette County, Kentucky",14,13,1
1000000US210670023011011,210670023011011,"Block 1011, Block Group 1, Census Tract 23.01, Fayette County, Kentucky",14,14,0
1000000US210670023012000,210670023012000,"Block 2000, Block Group 2, Census Tract 23.01, Fayette County, Kentucky",91,86,5
1000000US210670023012001,210670023012001,"Block 2001, Block Group 2, Census Tract 23.01, Fayette County, Kentucky",30,30,0
1000000US210670023012002,210670023012002,"Block 2002, Block Group 2, Census Tract 23.01, Fayette County, Kentucky",82,78,4
1000000US210670023012003,210670023012003,"Block 2003, Block Group 2, Census Tract 23.01, Fayette County, Kentucky",8,8,0
1000000US210670023012004,210670023012004,"Block 2004, Block Group 2, Census Tract 23.01, Fayette County, Kentucky",10,9,1
1000000US210670023012005,210670023012005,"Block 2005, Block Group 2, Census Tract 23.01, Fayette County, Kentucky",16,16,0
1000000US210670023012006,210670023012006,"Block 2006, Block Group 2, Census Tract 23.01, Fayette County, Kentucky",21,20,1
1000000US210670023012007,210670023012007,"Block 2007, Block Group 2, Census Tract 23.01, Fayette County, Kentucky",41,39,2
1000000US210670023012008,210670023012008,"Block 2008, Block Group 2, Census Tract 23.01, Fayette County, Kentucky",24,22,2
1000000US210670023012009,210670023012009,"Block 2009, Block Group 2, Census Tract 23.01, Fayette County, Kentucky",32,31,1
1000000US210670023013000,210670023013000,"Block 3000, Block Group 3, Census Tract 23.01, Fayette County, Kentucky",18,18,0
1000000US210670023013001,210670023013001,"Block 3001, Block Group 3, Census Tract 23.01, Fayette County, Kentucky",23,22,1
1000000US210670023013002,210670023013002,"Block 3002, Block Group 3, Census Tract 23.01, Fayette County, Kentucky",38,35,3
1000000US210670023013003,210670023013003,"Block 3003, Block Group 3, Census Tract 23.01, Fayette County, Kentucky",53,50,3
1000000US210670023013004,210670023013004,"Block 3004, Block Group 3, Census Tract 23.01, Fayette County, Kentucky",44,43,1
1000000US210670023013005,210670023013005,"Block 3005, Block Group 3, Census Tract 23.01, Fayette County, Kentucky",2,2,0
1000000US210670023013006,210670023013006,"Block 3006, Block Group 3, Census Tract 23.01, Fayette County, Kentucky",0,0,0
1000000US210670023013007,210670023013007,"Block 3007, Block Group 3, Census Tract 23.01, Fayette County, Kentucky",114,114,0
1000000US210670023013008,210670023013008,"Block 3008, Block Group 3, Census Tract 23.01, Fayette County, Kentucky",8,8,0
1000000US210670023013009,210670023013009,"Block 3009, Block Group 3, Census Tract 23.01, Fayette County, Kentucky",6,6,0
1000000US210670023013010,210670023013010,"Block 3010, Block Group 3, Census Tract 23.01, Fayette County, Kentucky",13,11,2
1000000US210670023013011,210670023013011,"Block 3011, Block Group 3, Census Tract 23.01, Fayette County, Kentucky",26,26,0
1000000US210670023013012,210670023013012,"Block 3012, Block Group 3, Census Tract 23.01, Fayette County, Kentucky",41,37,4
1000000US210670023013013,210670023013013,"Block 3013, Block Group 3, Census Tract 23.01, Fayette County, Kentucky",64,60,4
1000000US210670023013014,210670023013014,"Block 3014, Block Group 3, Census Tract 23.01, Fayette County, Kentucky",0,0,0
1000000US210670023013015,210670023013015,"Block 3015, Block Group 3, Census Tract 23.01, Fayette County, Kentucky",16,15,1
1000000US210670023013016,210670023013016,"Block 3016, Block Group 3, Census Tract 23.01, Fayette County, Kentucky",16,15,1
1000000US210670023013017,210670023013017,"Block 3017, Block Group 3, Census Tract 23.01, Fayette County, Kentucky",0,0,0
1000000US210670023013018,210670023013018,"Block 3018, Block Group 3, Census Tract 23.01, Fayette County, Kentucky",77,75,2
1000000US210670023013019,210670023013019,"Block 3019, Block Group 3, Census Tract 23.01, Fayette County, Kentucky",14,14,0
1000000US210670023013020,210670023013020,"Block 3020, Block Group 3, Census Tract 23.01, Fayette County, Kentucky",5,5,0
1000000US210670023013021,210670023013021,"Block 3021, Block Group 3, Census Tract 23.01, Fayette County, Kentucky",6,6,0
1000000US210670023014000,210670023014000,"Block 4000, Block Group 4, Census Tract 23.01, Fayette County, Kentucky",36,34,2
1000000US210670023014001,210670023014001,"Block 4001, Block Group 4, Census Tract 23.01, Fayette County, Kentucky",16,16,0
1000000US210670023014002,210670023014002,"Block 4002, Block Group 4, Census Tract 23.01, Fayette County, Kentucky",15,15,0
1000000US210670023014003,210670023014003,"Block 4003, Block Group 4, Census Tract 23.01, Fayette County, Kentucky",7,7,0
1000000US210670023014004,210670023014004,"Block 4004, Block Group 4, Census Tract 23.01, Fayette County, Kentucky",18,18,0
1000000US210670023014005,210670023014005,"Block 4005, Block Group 4, Census Tract 23.01, Fayette County, Kentucky",4,4,0
1000000US210670023014006,210670023014006,"Block 4006, Block Group 4, Census Tract 23.01, Fayette County, Kentucky",39,38,1
1000000US210670023014007,210670023014007,"Block 4007, Block Group 4, Census Tract 23.01, Fayette County, Kentucky",6,6,0
1000000US210670023014008,210670023014008,"Block 4008, Block Group 4, Census Tract 23.01, Fayette County, Kentucky",24,24,0
1000000US210670023014009,210670023014009,"Block 4009, Block Group 4, Census Tract 23.01, Fayette County, Kentucky",52,51,1
1000000US210670023014010,210670023014010,"Block 4010, Block Group 4, Census Tract 23.01, Fayette County, Kentucky",26,26,0
1000000US210670023014011,210670023014011,"Block 4011, Block Group 4, Census Tract 23.01, Fayette County, Kentucky",1,1,0
1000000US210670023014012,210670023014012,"Block 4012, Block Group 4, Census Tract 23.01, Fayette County, Kentucky",40,40,0
1000000US210670023014013,210670023014013,"Block 4013, Block Group 4, Census Tract 23.01, Fayette County, Kentucky",67,65,2
1000000US210670023014014,210670023014014,"Block 4014, Block Group 4, Census Tract 23.01, Fayette County, Kentucky",17,16,1
1000000US210670023014015,210670023014015,"Block 4015, Block Group 4, Census Tract 23.01, Fayette County, Kentucky",222,218,4
1000000US210670023014016,210670023014016,"Block 4016, Block Group 4, Census Tract 23.01, Fayette County, Kentucky",12,12,0
1000000US210670023014017,210670023014017,"Block 4017, Block Group 4, Census Tract 23.01, Fayette County, Kentucky",10,10,0
1000000US210670023014018,210670023014018,"Block 4018, Block Group 4, Census Tract 23.01, Fayette County, Kentucky",13,13,0
1000000US210670023014019,210670023014019,"Block 4019, Block Group 4, Census Tract 23.01, Fayette County, Kentucky",29,29,0
1000000US210670023014020,210670023014020,"Block 4020, Block Group 4, Census Tract 23.01, Fayette County, Kentucky",27,26,1
1000000US210670023014021,210670023014021,"Block 4021, Block Group 4, Census Tract 23.01, Fayette County, Kentucky",2,2,0
1000000US210670023014998,210670023014998,"Block 4998, Block Group 4, Census Tract 23.01, Fayette County, Kentucky",0,0,0
1000000US210670023014999,210670023014999,"Block 4999, Block Group 4, Census Tract 23.01, Fayette County, Kentucky",0,0,0
1000000US210670023021000,210670023021000,"Block 1000, Block Group 1, Census Tract 23.02, Fayette County, Kentucky",18,17,1
1000000US210670023021001,210670023021001,"Block 1001, Block Group 1, Census Tract 23.02, Fayette County, Kentucky",250,231,19
1000000US210670023021002,210670023021002,"Block 1002, Block Group 1, Census Tract 23.02, Fayette County, Kentucky",73,69,4
1000000US210670023021003,210670023021003,"Block 1003, Block Group 1, Census Tract 23.02, Fayette County, Kentucky",82,81,1
1000000US210670023021004,210670023021004,"Block 1004, Block Group 1, Census Tract 23.02, Fayette County, Kentucky",169,161,8
1000000US210670023021005,210670023021005,"Block 1005, Block Group 1, Census Tract 23.02, Fayette County, Kentucky",2,1,1
1000000US210670023021006,210670023021006,"Block 1006, Block Group 1, Census Tract 23.02, Fayette County, Kentucky",48,43,5
1000000US210670023021007,210670023021007,"Block 1007, Block Group 1, Census Tract 23.02, Fayette County, Kentucky",17,17,0
1000000US210670023021008,210670023021008,"Block 1008, Block Group 1, Census Tract 23.02, Fayette County, Kentucky",327,297,30
1000000US210670023021009,210670023021009,"Block 1009, Block Group 1, Census Tract 23.02, Fayette County, Kentucky",21,21,0
1000000US210670023021010,210670023021010,"Block 1010, Block Group 1, Census Tract 23.02, Fayette County, Kentucky",21,21,0
1000000US210670023021011,210670023021011,"Block 1011, Block Group 1, Census Tract 23.02, Fayette County, Kentucky",14,13,1
1000000US210670023022000,210670023022000,"Block 2000, Block Group 2, Census Tract 23.02, Fayette County, Kentucky",193,185,8
1000000US210670023022001,210670023022001,"Block 2001, Block Group 2, Census Tract 23.02, Fayette County, Kentucky",17,16,1
1000000US210670023022002,210670023022002,"Block 2002, Block Group 2, Census Tract 23.02, Fayette County, Kentucky",473,433,40
1000000US210670023022003,210670023022003,"Block 2003, Block Group 2, Census Tract 23.02, Fayette County, Kentucky",106,100,6
1000000US210670023022004,210670023022004,"Block 2004, Block Group 2, Census Tract 23.02, Fayette County, Kentucky",9,9,0
1000000US210670023022005,210670023022005,"Block 2005, Block Group 2, Census Tract 23.02, Fayette County, Kentucky",196,193,3
1000000US210670023022006,210670023022006,"Block 2006, Block Group 2, Census Tract 23.02, Fayette County, Kentucky",0,0,0
1000000US210670023022007,210670023022007,"Block 2007, Block Group 2, Census Tract 23.02, Fayette County, Kentucky",18,18,0
1000000US210670023022008,210670023022008,"Block 2008, Block Group 2, Census Tract 23.02, Fayette County, Kentucky",303,290,13
1000000US210670023022009,210670023022009,"Block 2009, Block Group 2, Census Tract 23.02, Fayette County, Kentucky",27,27,0
1000000US210670023022010,210670023022010,"Block 2010, Block Group 2, Census Tract 23.02, Fayette County, Kentucky",76,62,14
1000000US210670023022011,210670023022011,"Block 2011, Block Group 2, Census Tract 23.02, Fayette County, Kentucky",165,153,12
1000000US210670023022012,210670023022012,"Block 2012, Block Group 2, Census Tract 23.02, Fayette County, Kentucky",36,35,1
1000000US210670023022013,210670023022013,"Block 2013, Block Group 2, Census Tract 23.02, Fayette County, Kentucky",89,85,4
1000000US210670023022014,210670023022014,"Block 2014, Block Group 2, Census Tract 23.02, Fayette County, Kentucky",97,77,20
1000000US210670024001000,210670024001000,"Block 1000, Block Group 1, Census Tract 24, Fayette County, Kentucky",18,18,0
1000000US210670024001001,210670024001001,"Block 1001, Block Group 1, Census Tract 24, Fayette County, Kentucky",18,18,0
1000000US210670024001002,210670024001002,"Block 1002, Block Group 1, Census Tract 24, Fayette County, Kentucky",1,1,0
1000000US210670024001003,210670024001003,"Block 1003, Block Group 1, Census Tract 24, Fayette County, Kentucky",24,23,1
1000000US210670024001004,210670024001004,"Block 1004, Block Group 1, Census Tract 24, Fayette County, Kentucky",42,41,1
1000000US210670024001005,210670024001005,"Block 1005, Block Group 1, Census Tract 24, Fayette County, Kentucky",17,17,0
1000000US210670024001006,210670024001006,"Block 1006, Block Group 1, Census Tract 24, Fayette County, Kentucky",4,4,0
1000000US210670024001007,210670024001007,"Block 1007, Block Group 1, Census Tract 24, Fayette County, Kentucky",60,60,0
1000000US210670024001008,210670024001008,"Block 1008, Block Group 1, Census Tract 24, Fayette County, Kentucky",0,0,0
1000000US210670024001009,210670024001009,"Block 1009, Block Group 1, Census Tract 24, Fayette County, Kentucky",3,2,1
1000000US210670024002000,210670024002000,"Block 2000, Block Group 2, Census Tract 24, Fayette County, Kentucky",81,77,4
1000000US210670024002001,210670024002001,"Block 2001, Block Group 2, Census Tract 24, Fayette County, Kentucky",13,13,0
1000000US210670024002002,210670024002002,"Block 2002, Block Group 2, Census Tract 24, Fayette County, Kentucky",0,0,0
1000000US210670024002003,210670024002003,"Block 2003, Block Group 2, Census Tract 24, Fayette County, Kentucky",16,14,2
1000000US210670024002004,210670024002004,"Block 2004, Block Group 2, Census Tract 24, Fayette County, Kentucky",36,36,0
1000000US210670024002005,210670024002005,"Block 2005, Block Group 2, Census Tract 24, Fayette County, Kentucky",17,17,0
1000000US210670024002006,210670024002006,"Block 2006, Block Group 2, Census Tract 24, Fayette County, Kentucky",21,20,1
1000000US210670024002007,210670024002007,"Block 2007, Block Group 2, Census Tract 24, Fayette County, Kentucky",15,15,0
1000000US210670024002008,210670024002008,"Block 2008, Block Group 2, Census Tract 24, Fayette County, Kentucky",16,16,0
1000000US210670024002009,210670024002009,"Block 2009, Block Group 2, Census Tract 24, Fayette County, Kentucky",52,51,1
1000000US210670024002010,210670024002010,"Block 2010, Block Group 2, Census Tract 24, Fayette County, Kentucky",10,10,0
1000000US210670024003000,210670024003000,"Block 3000, Block Group 3, Census Tract 24, Fayette County, Kentucky",22,22,0
1000000US210670024003001,210670024003001,"Block 3001, Block Group 3, Census Tract 24, Fayette County, Kentucky",50,50,0
1000000US210670024003002,210670024003002,"Block 3002, Block Group 3, Census Tract 24, Fayette County, Kentucky",32,32,0
1000000US210670024003003,210670024003003,"Block 3003, Block Group 3, Census Tract 24, Fayette County, Kentucky",41,37,4
1000000US210670024003004,210670024003004,"Block 3004, Block Group 3, Census Tract 24, Fayette County, Kentucky",187,168,19
1000000US210670024003005,210670024003005,"Block 3005, Block Group 3, Census Tract 24, Fayette County, Kentucky",31,30,1
1000000US210670024003006,210670024003006,"Block 3006, Block Group 3, Census Tract 24, Fayette County, Kentucky",37,37,0
1000000US210670024003007,210670024003007,"Block 3007, Block Group 3, Census Tract 24, Fayette County, Kentucky",27,26,1
1000000US210670024003008,210670024003008,"Block 3008, Block Group 3, Census Tract 24, Fayette County, Kentucky",31,31,0
1000000US210670024003009,210670024003009,"Block 3009, Block Group 3, Census Tract 24, Fayette County, Kentucky",24,24,0
1000000US210670024004000,210670024004000,"Block 4000, Block Group 4, Census Tract 24, Fayette County, Kentucky",31,30,1
1000000US210670024004001,210670024004001,"Block 4001, Block Group 4, Census Tract 24, Fayette County, Kentucky",20,20,0
1000000US210670024004002,210670024004002,"Block 4002, Block Group 4, Census Tract 24, Fayette County, Kentucky",54,53,1
1000000US210670024004003,210670024004003,"Block 4003, Block Group 4, Census Tract 24, Fayette County, Kentucky",34,31,3
1000000US210670024004004,210670024004004,"Block 4004, Block Group 4, Census Tract 24, Fayette County, Kentucky",24,23,1
1000000US210670024004005,210670024004005,"Block 4005, Block Group 4, Census Tract 24, Fayette County, Kentucky",40,40,0
1000000US210670024004006,210670024004006,"Block 4006, Block Group 4, Census Tract 24, Fayette County, Kentucky",22,21,1
1000000US210670024004007,210670024004007,"Block 4007, Block Group 4, Census Tract 24, Fayette County, Kentucky",17,17,0
1000000US210670024004008,210670024004008,"Block 4008, Block Group 4, Census Tract 24, Fayette County, Kentucky",36,35,1
1000000US210670024004009,210670024004009,"Block 4009, Block Group 4, Census Tract 24, Fayette County, Kentucky",43,42,1
1000000US210670024004010,210670024004010,"Block 4010, Block Group 4, Census Tract 24, Fayette County, Kentucky",31,31,0
1000000US210670024004011,210670024004011,"Block 4011, Block Group 4, Census Tract 24, Fayette County, Kentucky",30,30,0
1000000US210670024005000,210670024005000,"Block 5000, Block Group 5, Census Tract 24, Fayette County, Kentucky",0,0,0
1000000US210670024005001,210670024005001,"Block 5001, Block Group 5, Census Tract 24, Fayette County, Kentucky",0,0,0
1000000US210670024005002,210670024005002,"Block 5002, Block Group 5, Census Tract 24, Fayette County, Kentucky",0,0,0
1000000US210670024005003,210670024005003,"Block 5003, Block Group 5, Census Tract 24, Fayette County, Kentucky",0,0,0
1000000US210670024005004,210670024005004,"Block 5004, Block Group 5, Census Tract 24, Fayette County, Kentucky",406,388,18
1000000US210670024005005,210670024005005,"Block 5005, Block Group 5, Census Tract 24, Fayette County, Kentucky",26,26,0
1000000US210670024005006,210670024005006,"Block 5006, Block Group 5, Census Tract 24, Fayette County, Kentucky",13,12,1
1000000US210670024005007,210670024005007,"Block 5007, Block Group 5, Census Tract 24, Fayette County, Kentucky",17,17,0
1000000US210670025001000,210670025001000,"Block 1000, Block Group 1, Census Tract 25, Fayette County, Kentucky",8,6,2
1000000US210670025001001,210670025001001,"Block 1001, Block Group 1, Census Tract 25, Fayette County, Kentucky",14,11,3
1000000US210670025001002,210670025001002,"Block 1002, Block Group 1, Census Tract 25, Fayette County, Kentucky",40,36,4
1000000US210670025001003,210670025001003,"Block 1003, Block Group 1, Census Tract 25, Fayette County, Kentucky",330,307,23
1000000US210670025001004,210670025001004,"Block 1004, Block Group 1, Census Tract 25, Fayette County, Kentucky",18,18,0
1000000US210670025001005,210670025001005,"Block 1005, Block Group 1, Census Tract 25, Fayette County, Kentucky",35,34,1
1000000US210670025001006,210670025001006,"Block 1006, Block Group 1, Census Tract 25, Fayette County, Kentucky",10,9,1
1000000US210670025001007,210670025001007,"Block 1007, Block Group 1, Census Tract 25, Fayette County, Kentucky",45,44,1
1000000US210670025001008,210670025001008,"Block 1008, Block Group 1, Census Tract 25, Fayette County, Kentucky",39,36,3
1000000US210670025001009,210670025001009,"Block 1009, Block Group 1, Census Tract 25, Fayette County, Kentucky",38,37,1
1000000US210670025001010,210670025001010,"Block 1010, Block Group 1, Census Tract 25, Fayette County, Kentucky",160,157,3
1000000US210670025001011,210670025001011,"Block 1011, Block Group 1, Census Tract 25, Fayette County, Kentucky",47,46,1
1000000US210670025001012,210670025001012,"Block 1012, Block Group 1, Census Tract 25, Fayette County, Kentucky",4,3,1
1000000US210670025001013,210670025001013,"Block 1013, Block Group 1, Census Tract 25, Fayette County, Kentucky",26,24,2
1000000US210670025001014,210670025001014,"Block 1014, Block Group 1, Census Tract 25, Fayette County, Kentucky",190,186,4
1000000US210670025001015,210670025001015,"Block 1015, Block Group 1, Census Tract 25, Fayette County, Kentucky",58,54,4
1000000US210670025001016,210670025001016,"Block 1016, Block Group 1, Census Tract 25, Fayette County, Kentucky",0,0,0
1000000US210670025001017,210670025001017,"Block 1017, Block Group 1, Census Tract 25, Fayette County, Kentucky",86,78,8
1000000US210670025001018,210670025001018,"Block 1018, Block Group 1, Census Tract 25, Fayette County, Kentucky",27,25,2
1000000US210670025001019,210670025001019,"Block 1019, Block Group 1, Census Tract 25, Fayette County, Kentucky",3,3,0
1000000US210670025001020,210670025001020,"Block 1020, Block Group 1, Census Tract 25, Fayette County, Kentucky",34,32,2
1000000US210670025002000,210670025002000,"Block 2000, Block Group 2, Census Tract 25, Fayette County, Kentucky",32,31,1
1000000US210670025002001,210670025002001,"Block 2001, Block Group 2, Census Tract 25, Fayette County, Kentucky",0,0,0
1000000US210670025002002,210670025002002,"Block 2002, Block Group 2, Census Tract 25, Fayette County, Kentucky",9,8,1
1000000US210670025002003,210670025002003,"Block 2003, Block Group 2, Census Tract 25, Fayette County, Kentucky",46,44,2
1000000US210670025002004,210670025002004,"Block 2004, Block Group 2, Census Tract 25, Fayette County, Kentucky",40,36,4
1000000US210670025002005,210670025002005,"Block 2005, Block Group 2, Census Tract 25, Fayette County, Kentucky",33,33,0
1000000US210670025002006,210670025002006,"Block 2006, Block Group 2, Census Tract 25, Fayette County, Kentucky",12,10,2
1000000US210670025002007,210670025002007,"Block 2007, Block Group 2, Census Tract 25, Fayette County, Kentucky",22,21,1
1000000US210670025002008,210670025002008,"Block 2008, Block Group 2, Census Tract 25, Fayette County, Kentucky",19,18,1
1000000US210670025002009,210670025002009,"Block 2009, Block Group 2, Census Tract 25, Fayette County, Kentucky",28,26,2
1000000US210670025002010,210670025002010,"Block 2010, Block Group 2, Census Tract 25, Fayette County, Kentucky",0,0,0
1000000US210670025002011,210670025002011,"Block 2011, Block Group 2, Census Tract 25, Fayette County, Kentucky",41,38,3
1000000US210670025002012,210670025002012,"Block 2012, Block Group 2, Census Tract 25, Fayette County, Kentucky",0,0,0
1000000US210670025002013,210670025002013,"Block 2013, Block Group 2, Census Tract 25, Fayette County, Kentucky",9,7,2
1000000US210670025002014,210670025002014,"Block 2014, Block Group 2, Census Tract 25, Fayette County, Kentucky",0,0,0
1000000US210670025002015,210670025002015,"Block 2015, Block Group 2, Census Tract 25, Fayette County, Kentucky",18,17,1
1000000US210670025002016,210670025002016,"Block 2016, Block Group 2, Census Tract 25, Fayette County, Kentucky",0,0,0
1000000US210670025002017,210670025002017,"Block 2017, Block Group 2, Census Tract 25, Fayette County, Kentucky",31,31,0
1000000US210670025002018,210670025002018,"Block 2018, Block Group 2, Census Tract 25, Fayette County, Kentucky",31,29,2
1000000US210670025002019,210670025002019,"Block 2019, Block Group 2, Census Tract 25, Fayette County, Kentucky",37,36,1
1000000US210670025002020,210670025002020,"Block 2020, Block Group 2, Census Tract 25, Fayette County, Kentucky",76,74,2
1000000US210670025002021,210670025002021,"Block 2021, Block Group 2, Census Tract 25, Fayette County, Kentucky",16,14,2
1000000US210670025002022,210670025002022,"Block 2022, Block Group 2, Census Tract 25, Fayette County, Kentucky",4,3,1
1000000US210670026001000,210670026001000,"Block 1000, Block Group 1, Census Tract 26, Fayette County, Kentucky",0,0,0
1000000US210670026001001,210670026001001,"Block 1001, Block Group 1, Census Tract 26, Fayette County, Kentucky",0,0,0
1000000US210670026001002,210670026001002,"Block 1002, Block Group 1, Census Tract 26, Fayette County, Kentucky",389,365,24
1000000US210670026001003,210670026001003,"Block 1003, Block Group 1, Census Tract 26, Fayette County, Kentucky",35,35,0
1000000US210670026001004,210670026001004,"Block 1004, Block Group 1, Census Tract 26, Fayette County, Kentucky",78,74,4
1000000US210670026001005,210670026001005,"Block 1005, Block Group 1, Census Tract 26, Fayette County, Kentucky",19,19,0
1000000US210670026001006,210670026001006,"Block 1006, Block Group 1, Census Tract 26, Fayette County, Kentucky",28,26,2
1000000US210670026001007,210670026001007,"Block 1007, Block Group 1, Census Tract 26, Fayette County, Kentucky",31,31,0
1000000US210670026001008,210670026001008,"Block 1008, Block Group 1, Census Tract 26, Fayette County, Kentucky",80,79,1
1000000US210670026001009,210670026001009,"Block 1009, Block Group 1, Census Tract 26, Fayette County, Kentucky",25,24,1
1000000US210670026001010,210670026001010,"Block 1010, Block Group 1, Census Tract 26, Fayette County, Kentucky",25,23,2
1000000US210670026001011,210670026001011,"Block 1011, Block Group 1, Census Tract 26, Fayette County, Kentucky",53,52,1
1000000US210670026001012,210670026001012,"Block 1012, Block Group 1, Census Tract 26, Fayette County, Kentucky",52,49,3
1000000US210670026001013,210670026001013,"Block 1013, Block Group 1, Census Tract 26, Fayette County, Kentucky",0,0,0
1000000US210670026001014,210670026001014,"Block 1014, Block Group 1, Census Tract 26, Fayette County, Kentucky",0,0,0
1000000US210670026002000,210670026002000,"Block 2000, Block Group 2, Census Tract 26, Fayette County, Kentucky",57,55,2
1000000US210670026002001,210670026002001,"Block 2001, Block Group 2, Census Tract 26, Fayette County, Kentucky",49,48,1
1000000US210670026002002,210670026002002,"Block 2002, Block Group 2, Census Tract 26, Fayette County, Kentucky",51,49,2
1000000US210670026002003,210670026002003,"Block 2003, Block Group 2, Census Tract 26, Fayette County, Kentucky",25,23,2
1000000US210670026002004,210670026002004,"Block 2004, Block Group 2, Census Tract 26, Fayette County, Kentucky",12,12,0
1000000US210670026002005,210670026002005,"Block 2005, Block Group 2, Census Tract 26, Fayette County, Kentucky",0,0,0
1000000US210670026002006,210670026002006,"Block 2006, Block Group 2, Census Tract 26, Fayette County, Kentucky",4,4,0
1000000US210670026002007,210670026002007,"Block 2007, Block Group 2, Census Tract 26, Fayette County, Kentucky",0,0,0
1000000US210670026002008,210670026002008,"Block 2008, Block Group 2, Census Tract 26, Fayette County, Kentucky",126,116,10
1000000US210670026002009,210670026002009,"Block 2009, Block Group 2, Census Tract 26, Fayette County, Kentucky",138,133,5
1000000US210670026003000,210670026003000,"Block 3000, Block Group 3, Census Tract 26, Fayette County, Kentucky",38,38,0
1000000US210670026003001,210670026003001,"Block 3001, Block Group 3, Census Tract 26, Fayette County, Kentucky",39,38,1
1000000US210670026003002,210670026003002,"Block 3002, Block Group 3, Census Tract 26, Fayette County, Kentucky",42,41,1
1000000US210670026003003,210670026003003,"Block 3003, Block Group 3, Census Tract 26, Fayette County, Kentucky",45,43,2
1000000US210670026003004,210670026003004,"Block 3004, Block Group 3, Census Tract 26, Fayette County, Kentucky",45,44,1
1000000US210670026003005,210670026003005,"Block 3005, Block Group 3, Census Tract 26, Fayette County, Kentucky",53,53,0
1000000US210670026003006,210670026003006,"Block 3006, Block Group 3, Census Tract 26, Fayette County, Kentucky",28,27,1
1000000US210670026003007,210670026003007,"Block 3007, Block Group 3, Census Tract 26, Fayette County, Kentucky",21,21,0
1000000US210670026003008,210670026003008,"Block 3008, Block Group 3, Census Tract 26, Fayette County, Kentucky",26,25,1
1000000US210670026003009,210670026003009,"Block 3009, Block Group 3, Census Tract 26, Fayette County, Kentucky",37,35,2
1000000US210670026003010,210670026003010,"Block 3010, Block Group 3, Census Tract 26, Fayette County, Kentucky",39,38,1
1000000US210670026003011,210670026003011,"Block 3011, Block Group 3, Census Tract 26, Fayette County, Kentucky",58,56,2
1000000US210670026003012,210670026003012,"Block 3012, Block Group 3, Census Tract 26, Fayette County, Kentucky",22,21,1
1000000US210670026003013,210670026003013,"Block 3013, Block Group 3, Census Tract 26, Fayette County, Kentucky",19,19,0
1000000US210670026004000,210670026004000,"Block 4000, Block Group 4, Census Tract 26, Fayette County, Kentucky",66,66,0
1000000US210670026004001,210670026004001,"Block 4001, Block Group 4, Census Tract 26, Fayette County, Kentucky",66,64,2
1000000US210670026004002,210670026004002,"Block 4002, Block Group 4, Census Tract 26, Fayette County, Kentucky",96,89,7
1000000US210670026004003,210670026004003,"Block 4003, Block Group 4, Census Tract 26, Fayette County, Kentucky",47,46,1
1000000US210670026004004,210670026004004,"Block 4004, Block Group 4, Census Tract 26, Fayette County, Kentucky",41,41,0
1000000US210670026004005,210670026004005,"Block 4005, Block Group 4, Census Tract 26, Fayette County, Kentucky",26,26,0
1000000US210670026004006,210670026004006,"Block 4006, Block Group 4, Census Tract 26, Fayette County, Kentucky",35,35,0
1000000US210670026005000,210670026005000,"Block 5000, Block Group 5, Census Tract 26, Fayette County, Kentucky",17,17,0
1000000US210670026005001,210670026005001,"Block 5001, Block Group 5, Census Tract 26, Fayette County, Kentucky",286,275,11
1000000US210670026005002,210670026005002,"Block 5002, Block Group 5, Census Tract 26, Fayette County, Kentucky",12,12,0
1000000US210670026005003,210670026005003,"Block 5003, Block Group 5, Census Tract 26, Fayette County, Kentucky",0,0,0
1000000US210670026005004,210670026005004,"Block 5004, Block Group 5, Census Tract 26, Fayette County, Kentucky",159,129,30
1000000US210670027001000,210670027001000,"Block 1000, Block Group 1, Census Tract 27, Fayette County, Kentucky",12,12,0
1000000US210670027001001,210670027001001,"Block 1001, Block Group 1, Census Tract 27, Fayette County, Kentucky",129,114,15
1000000US210670027001002,210670027001002,"Block 1002, Block Group 1, Census Tract 27, Fayette County, Kentucky",12,12,0
1000000US210670027001003,210670027001003,"Block 1003, Block Group 1, Census Tract 27, Fayette County, Kentucky",9,9,0
1000000US210670027001004,210670027001004,"Block 1004, Block Group 1, Census Tract 27, Fayette County, Kentucky",11,11,0
1000000US210670027001005,210670027001005,"Block 1005, Block Group 1, Census Tract 27, Fayette County, Kentucky",10,10,0
1000000US210670027001006,210670027001006,"Block 1006, Block Group 1, Census Tract 27, Fayette County, Kentucky",36,36,0
1000000US210670027001007,210670027001007,"Block 1007, Block Group 1, Census Tract 27, Fayette County, Kentucky",13,12,1
1000000US210670027001008,210670027001008,"Block 1008, Block Group 1, Census Tract 27, Fayette County, Kentucky",60,59,1
1000000US210670027001009,210670027001009,"Block 1009, Block Group 1, Census Tract 27, Fayette County, Kentucky",305,266,39
1000000US210670027001010,210670027001010,"Block 1010, Block Group 1, Census Tract 27, Fayette County, Kentucky",38,37,1
1000000US210670027001011,210670027001011,"Block 1011, Block Group 1, Census Tract 27, Fayette County, Kentucky",22,22,0
1000000US210670027002000,210670027002000,"Block 2000, Block Group 2, Census Tract 27, Fayette County, Kentucky",6,6,0
1000000US210670027002001,210670027002001,"Block 2001, Block Group 2, Census Tract 27, Fayette County, Kentucky",92,92,0
1000000US210670027002002,210670027002002,"Block 2002, Block Group 2, Census Tract 27, Fayette County, Kentucky",11,11,0
1000000US210670027002003,210670027002003,"Block 2003, Block Group 2, Census Tract 27, Fayette County, Kentucky",13,13,0
1000000US210670027002004,210670027002004,"Block 2004, Block Group 2, Census Tract 27, Fayette County, Kentucky",45,45,0
1000000US210670027002005,210670027002005,"Block 2005, Block Group 2, Census Tract 27, Fayette County, Kentucky",14,14,0
1000000US210670027002006,210670027002006,"Block 2006, Block Group 2, Census Tract 27, Fayette County, Kentucky",23,23,0
1000000US210670027002007,210670027002007,"Block 2007, Block Group 2, Census Tract 27, Fayette County, Kentucky",389,357,32
1000000US210670027002008,210670027002008,"Block 2008, Block Group 2, Census Tract 27, Fayette County, Kentucky",16,16,0
1000000US210670027002009,210670027002009,"Block 2009, Block Group 2, Census Tract 27, Fayette County, Kentucky",24,24,0
1000000US210670027002010,210670027002010,"Block 2010, Block Group 2, Census Tract 27, Fayette County, Kentucky",12,11,1
1000000US210670027002011,210670027002011,"Block 2011, Block Group 2, Census Tract 27, Fayette County, Kentucky",17,15,2
1000000US210670027002012,210670027002012,"Block 2012, Block Group 2, Census Tract 27, Fayette County, Kentucky",8,8,0
1000000US210670027002013,210670027002013,"Block 2013, Block Group 2, Census Tract 27, Fayette County, Kentucky",156,138,18
1000000US210670027002014,210670027002014,"Block 2014, Block Group 2, Census Tract 27, Fayette County, Kentucky",0,0,0
1000000US210670027002015,210670027002015,"Block 2015, Block Group 2, Census Tract 27, Fayette County, Kentucky",49,41,8
1000000US210670027003000,210670027003000,"Block 3000, Block Group 3, Census Tract 27, Fayette County, Kentucky",14,14,0
1000000US210670027003001,210670027003001,"Block 3001, Block Group 3, Census Tract 27, Fayette County, Kentucky",28,27,1
1000000US210670027003002,210670027003002,"Block 3002, Block Group 3, Census Tract 27, Fayette County, Kentucky",33,33,0
1000000US210670027003003,210670027003003,"Block 3003, Block Group 3, Census Tract 27, Fayette County, Kentucky",14,14,0
1000000US210670027003004,210670027003004,"Block 3004, Block Group 3, Census Tract 27, Fayette County, Kentucky",13,12,1
1000000US210670027003005,210670027003005,"Block 3005, Block Group 3, Census Tract 27, Fayette County, Kentucky",41,41,0
1000000US210670027003006,210670027003006,"Block 3006, Block Group 3, Census Tract 27, Fayette County, Kentucky",71,71,0
1000000US210670027003007,210670027003007,"Block 3007, Block Group 3, Census Tract 27, Fayette County, Kentucky",278,256,22
1000000US210670027003008,210670027003008,"Block 3008, Block Group 3, Census Tract 27, Fayette County, Kentucky",25,25,0
1000000US210670027003009,210670027003009,"Block 3009, Block Group 3, Census Tract 27, Fayette County, Kentucky",30,30,0
1000000US210670027003010,210670027003010,"Block 3010, Block Group 3, Census Tract 27, Fayette County, Kentucky",26,24,2
1000000US210670027003011,210670027003011,"Block 3011, Block Group 3, Census Tract 27, Fayette County, Kentucky",1,1,0
1000000US210670027003012,210670027003012,"Block 3012, Block Group 3, Census Tract 27, Fayette County, Kentucky",2,2,0
1000000US210670027003013,210670027003013,"Block 3013, Block Group 3, Census Tract 27, Fayette County, Kentucky",23,23,0
1000000US210670027003014,210670027003014,"Block 3014, Block Group 3, Census Tract 27, Fayette County, Kentucky",45,43,2
1000000US210670028001000,210670028001000,"Block 1000, Block Group 1, Census Tract 28, Fayette County, Kentucky",70,67,3
1000000US210670028001001,210670028001001,"Block 1001, Block Group 1, Census Tract 28, Fayette County, Kentucky",86,81,5
1000000US210670028001002,210670028001002,"Block 1002, Block Group 1, Census Tract 28, Fayette County, Kentucky",29,27,2
1000000US210670028001003,210670028001003,"Block 1003, Block Group 1, Census Tract 28, Fayette County, Kentucky",48,48,0
1000000US210670028001004,210670028001004,"Block 1004, Block Group 1, Census Tract 28, Fayette County, Kentucky",21,21,0
1000000US210670028001005,210670028001005,"Block 1005, Block Group 1, Census Tract 28, Fayette County, Kentucky",37,37,0
1000000US210670028001006,210670028001006,"Block 1006, Block Group 1, Census Tract 28, Fayette County, Kentucky",149,142,7
1000000US210670028001007,210670028001007,"Block 1007, Block Group 1, Census Tract 28, Fayette County, Kentucky",0,0,0
1000000US210670028001008,210670028001008,"Block 1008, Block Group 1, Census Tract 28, Fayette County, Kentucky",118,117,1
1000000US210670028001009,210670028001009,"Block 1009, Block Group 1, Census Tract 28, Fayette County, Kentucky",22,20,2
1000000US210670028001010,210670028001010,"Block 1010, Block Group 1, Census Tract 28, Fayette County, Kentucky",33,32,1
1000000US210670028001011,210670028001011,"Block 1011, Block Group 1, Census Tract 28, Fayette County, Kentucky",75,72,3
1000000US210670028001012,210670028001012,"Block 1012, Block Group 1, Census Tract 28, Fayette County, Kentucky",0,0,0
1000000US210670028001013,210670028001013,"Block 1013, Block Group 1, Census Tract 28, Fayette County, Kentucky",8,8,0
1000000US210670028001014,210670028001014,"Block 1014, Block Group 1, Census Tract 28, Fayette County, Kentucky",119,115,4
1000000US210670028001015,210670028001015,"Block 1015, Block Group 1, Census Tract 28, Fayette County, Kentucky",0,0,0
1000000US210670028001016,210670028001016,"Block 1016, Block Group 1, Census Tract 28, Fayette County, Kentucky",8,8,0
1000000US210670028001017,210670028001017,"Block 1017, Block Group 1, Census Tract 28, Fayette County, Kentucky",30,30,0
1000000US210670028001018,210670028001018,"Block 1018, Block Group 1, Census Tract 28, Fayette County, Kentucky",182,165,17
1000000US210670028001019,210670028001019,"Block 1019, Block Group 1, Census Tract 28, Fayette County, Kentucky",13,13,0
1000000US210670028001020,210670028001020,"Block 1020, Block Group 1, Census Tract 28, Fayette County, Kentucky",18,16,2
1000000US210670028001021,210670028001021,"Block 1021, Block Group 1, Census Tract 28, Fayette County, Kentucky",12,12,0
1000000US210670028001022,210670028001022,"Block 1022, Block Group 1, Census Tract 28, Fayette County, Kentucky",25,25,0
1000000US210670028001023,210670028001023,"Block 1023, Block Group 1, Census Tract 28, Fayette County, Kentucky",26,26,0
1000000US210670028001024,210670028001024,"Block 1024, Block Group 1, Census Tract 28, Fayette County, Kentucky",38,38,0
1000000US210670028001025,210670028001025,"Block 1025, Block Group 1, Census Tract 28, Fayette County, Kentucky",27,27,0
1000000US210670028001026,210670028001026,"Block 1026, Block Group 1, Census Tract 28, Fayette County, Kentucky",43,43,0
1000000US210670028001027,210670028001027,"Block 1027, Block Group 1, Census Tract 28, Fayette County, Kentucky",78,78,0
1000000US210670028001028,210670028001028,"Block 1028, Block Group 1, Census Tract 28, Fayette County, Kentucky",25,25,0
1000000US210670028001029,210670028001029,"Block 1029, Block Group 1, Census Tract 28, Fayette County, Kentucky",22,22,0
1000000US210670028001030,210670028001030,"Block 1030, Block Group 1, Census Tract 28, Fayette County, Kentucky",21,21,0
1000000US210670028001031,210670028001031,"Block 1031, Block Group 1, Census Tract 28, Fayette County, Kentucky",25,24,1
1000000US210670028001032,210670028001032,"Block 1032, Block Group 1, Census Tract 28, Fayette County, Kentucky",30,29,1
1000000US210670028001033,210670028001033,"Block 1033, Block Group 1, Census Tract 28, Fayette County, Kentucky",25,23,2
1000000US210670028001034,210670028001034,"Block 1034, Block Group 1, Census Tract 28, Fayette County, Kentucky",0,0,0
1000000US210670028001035,210670028001035,"Block 1035, Block Group 1, Census Tract 28, Fayette County, Kentucky",3,3,0
1000000US210670028001036,210670028001036,"Block 1036, Block Group 1, Census Tract 28, Fayette County, Kentucky",13,12,1
1000000US210670028001037,210670028001037,"Block 1037, Block Group 1, Census Tract 28, Fayette County, Kentucky",76,73,3
1000000US210670028001038,210670028001038,"Block 1038, Block Group 1, Census Tract 28, Fayette County, Kentucky",0,0,0
1000000US210670028001039,210670028001039,"Block 1039, Block Group 1, Census Tract 28, Fayette County, Kentucky",0,0,0
1000000US210670028001040,210670028001040,"Block 1040, Block Group 1, Census Tract 28, Fayette County, Kentucky",0,0,0
1000000US210670028001041,210670028001041,"Block 1041, Block Group 1, Census Tract 28, Fayette County, Kentucky",18,18,0
1000000US210670028001042,210670028001042,"Block 1042, Block Group 1, Census Tract 28, Fayette County, Kentucky",111,109,2
1000000US210670028001043,210670028001043,"Block 1043, Block Group 1, Census Tract 28, Fayette County, Kentucky",27,25,2
1000000US210670028001044,210670028001044,"Block 1044, Block Group 1, Census Tract 28, Fayette County, Kentucky",24,24,0
1000000US210670028001045,210670028001045,"Block 1045, Block Group 1, Census Tract 28, Fayette County, Kentucky",7,7,0
1000000US210670028001046,210670028001046,"Block 1046, Block Group 1, Census Tract 28, Fayette County, Kentucky",0,0,0
1000000US210670028001047,210670028001047,"Block 1047, Block Group 1, Census Tract 28, Fayette County, Kentucky",13,13,0
1000000US210670028001048,210670028001048,"Block 1048, Block Group 1, Census Tract 28, Fayette County, Kentucky",32,31,1
1000000US210670028001049,210670028001049,"Block 1049, Block Group 1, Census Tract 28, Fayette County, Kentucky",12,12,0
1000000US210670029001000,210670029001000,"Block 1000, Block Group 1, Census Tract 29, Fayette County, Kentucky",18,17,1
1000000US210670029001001,210670029001001,"Block 1001, Block Group 1, Census Tract 29, Fayette County, Kentucky",3,3,0
1000000US210670029001002,210670029001002,"Block 1002, Block Group 1, Census Tract 29, Fayette County, Kentucky",29,27,2
1000000US210670029001003,210670029001003,"Block 1003, Block Group 1, Census Tract 29, Fayette County, Kentucky",40,39,1
1000000US210670029001004,210670029001004,"Block 1004, Block Group 1, Census Tract 29, Fayette County, Kentucky",42,41,1
1000000US210670029001005,210670029001005,"Block 1005, Block Group 1, Census Tract 29, Fayette County, Kentucky",39,38,1
1000000US210670029001006,210670029001006,"Block 1006, Block Group 1, Census Tract 29, Fayette County, Kentucky",34,33,1
1000000US210670029001007,210670029001007,"Block 1007, Block Group 1, Census Tract 29, Fayette County, Kentucky",40,40,0
1000000US210670029001008,210670029001008,"Block 1008, Block Group 1, Census Tract 29, Fayette County, Kentucky",46,46,0
1000000US210670029001009,210670029001009,"Block 1009, Block Group 1, Census Tract 29, Fayette County, Kentucky",12,12,0
1000000US210670029001010,210670029001010,"Block 1010, Block Group 1, Census Tract 29, Fayette County, Kentucky",24,23,1
1000000US210670029001011,210670029001011,"Block 1011, Block Group 1, Census Tract 29, Fayette County, Kentucky",29,29,0
1000000US210670029001012,210670029001012,"Block 1012, Block Group 1, Census Tract 29, Fayette County, Kentucky",9,8,1
1000000US210670029001013,210670029001013,"Block 1013, Block Group 1, Census Tract 29, Fayette County, Kentucky",19,18,1
1000000US210670029001014,210670029001014,"Block 1014, Block Group 1, Census Tract 29, Fayette County, Kentucky",30,29,1
1000000US210670029001015,210670029001015,"Block 1015, Block Group 1, Census Tract 29, Fayette County, Kentucky",63,61,2
1000000US210670029001016,210670029001016,"Block 1016, Block Group 1, Census Tract 29, Fayette County, Kentucky",33,32,1
1000000US210670029001017,210670029001017,"Block 1017, Block Group 1, Census Tract 29, Fayette County, Kentucky",18,18,0
1000000US210670029001018,210670029001018,"Block 1018, Block Group 1, Census Tract 29, Fayette County, Kentucky",19,18,1
1000000US210670029001019,210670029001019,"Block 1019, Block Group 1, Census Tract 29, Fayette County, Kentucky",132,130,2
1000000US210670029001020,210670029001020,"Block 1020, Block Group 1, Census Tract 29, Fayette County, Kentucky",36,35,1
1000000US210670029001021,210670029001021,"Block 1021, Block Group 1, Census Tract 29, Fayette County, Kentucky",20,20,0
1000000US210670029001022,210670029001022,"Block 1022, Block Group 1, Census Tract 29, Fayette County, Kentucky",6,6,0
1000000US210670029001023,210670029001023,"Block 1023, Block Group 1, Census Tract 29, Fayette County, Kentucky",0,0,0
1000000US210670029002000,210670029002000,"Block 2000, Block Group 2, Census Tract 29, Fayette County, Kentucky",32,31,1
1000000US210670029002001,210670029002001,"Block 2001, Block Group 2, Census Tract 29, Fayette County, Kentucky",84,81,3
1000000US210670029002002,210670029002002,"Block 2002, Block Group 2, Census Tract 29, Fayette County, Kentucky",71,67,4
1000000US210670029002003,210670029002003,"Block 2003, Block Group 2, Census Tract 29, Fayette County, Kentucky",85,82,3
1000000US210670029002004,210670029002004,"Block 2004, Block Group 2, Census Tract 29, Fayette County, Kentucky",39,36,3
1000000US210670029002005,210670029002005,"Block 2005, Block Group 2, Census Tract 29, Fayette County, Kentucky",96,96,0
1000000US210670029002006,210670029002006,"Block 2006, Block Group 2, Census Tract 29, Fayette County, Kentucky",48,47,1
1000000US210670029002007,210670029002007,"Block 2007, Block Group 2, Census Tract 29, Fayette County, Kentucky",47,46,1
1000000US210670029002008,210670029002008,"Block 2008, Block Group 2, Census Tract 29, Fayette County, Kentucky",22,22,0
1000000US210670029002009,210670029002009,"Block 2009, Block Group 2, Census Tract 29, Fayette County, Kentucky",38,38,0
1000000US210670029002010,210670029002010,"Block 2010, Block Group 2, Census Tract 29, Fayette County, Kentucky",35,35,0
1000000US210670029002011,210670029002011,"Block 2011, Block Group 2, Census Tract 29, Fayette County, Kentucky",15,14,1
1000000US210670029002012,210670029002012,"Block 2012, Block Group 2, Census Tract 29, Fayette County, Kentucky",22,22,0
1000000US210670029002013,210670029002013,"Block 2013, Block Group 2, Census Tract 29, Fayette County, Kentucky",89,88,1
1000000US210670029002014,210670029002014,"Block 2014, Block Group 2, Census Tract 29, Fayette County, Kentucky",17,17,0
1000000US210670029002015,210670029002015,"Block 2015, Block Group 2, Census Tract 29, Fayette County, Kentucky",41,40,1
1000000US210670029002016,210670029002016,"Block 2016, Block Group 2, Census Tract 29, Fayette County, Kentucky",40,39,1
1000000US210670029002017,210670029002017,"Block 2017, Block Group 2, Census Tract 29, Fayette County, Kentucky",36,36,0
1000000US210670029002018,210670029002018,"Block 2018, Block Group 2, Census Tract 29, Fayette County, Kentucky",74,73,1
1000000US210670029002019,210670029002019,"Block 2019, Block Group 2, Census Tract 29, Fayette County, Kentucky",94,94,0
1000000US210670029002020,210670029002020,"Block 2020, Block Group 2, Census Tract 29, Fayette County, Kentucky",30,29,1
1000000US210670029002021,210670029002021,"Block 2021, Block Group 2, Census Tract 29, Fayette County, Kentucky",93,93,0
1000000US210670029002022,210670029002022,"Block 2022, Block Group 2, Census Tract 29, Fayette County, Kentucky",8,8,0
1000000US210670029002023,210670029002023,"Block 2023, Block Group 2, Census Tract 29, Fayette County, Kentucky",32,30,2
1000000US210670029002024,210670029002024,"Block 2024, Block Group 2, Census Tract 29, Fayette County, Kentucky",9,9,0
1000000US210670030001000,210670030001000,"Block 1000, Block Group 1, Census Tract 30, Fayette County, Kentucky",489,432,57
1000000US210670030001001,210670030001001,"Block 1001, Block Group 1, Census Tract 30, Fayette County, Kentucky",86,83,3
1000000US210670030001002,210670030001002,"Block 1002, Block Group 1, Census Tract 30, Fayette County, Kentucky",21,19,2
1000000US210670030001003,210670030001003,"Block 1003, Block Group 1, Census Tract 30, Fayette County, Kentucky",32,31,1
1000000US210670030001004,210670030001004,"Block 1004, Block Group 1, Census Tract 30, Fayette County, Kentucky",34,30,4
1000000US210670030001005,210670030001005,"Block 1005, Block Group 1, Census Tract 30, Fayette County, Kentucky",48,47,1
1000000US210670030001006,210670030001006,"Block 1006, Block Group 1, Census Tract 30, Fayette County, Kentucky",37,36,1
1000000US210670030001007,210670030001007,"Block 1007, Block Group 1, Census Tract 30, Fayette County, Kentucky",45,44,1
1000000US210670030001008,210670030001008,"Block 1008, Block Group 1, Census Tract 30, Fayette County, Kentucky",48,48,0
1000000US210670030002000,210670030002000,"Block 2000, Block Group 2, Census Tract 30, Fayette County, Kentucky",39,39,0
1000000US210670030002001,210670030002001,"Block 2001, Block Group 2, Census Tract 30, Fayette County, Kentucky",36,35,1
1000000US210670030002002,210670030002002,"Block 2002, Block Group 2, Census Tract 30, Fayette County, Kentucky",113,107,6
1000000US210670030002003,210670030002003,"Block 2003, Block Group 2, Census Tract 30, Fayette County, Kentucky",21,21,0
1000000US210670030002004,210670030002004,"Block 2004, Block Group 2, Census Tract 30, Fayette County, Kentucky",23,23,0
1000000US210670030002005,210670030002005,"Block 2005, Block Group 2, Census Tract 30, Fayette County, Kentucky",24,24,0
1000000US210670030002006,210670030002006,"Block 2006, Block Group 2, Census Tract 30, Fayette County, Kentucky",22,22,0
1000000US210670030002007,210670030002007,"Block 2007, Block Group 2, Census Tract 30, Fayette County, Kentucky",32,31,1
1000000US210670030002008,210670030002008,"Block 2008, Block Group 2, Census Tract 30, Fayette County, Kentucky",231,221,10
1000000US210670030002009,210670030002009,"Block 2009, Block Group 2, Census Tract 30, Fayette County, Kentucky",56,55,1
1000000US210670030002010,210670030002010,"Block 2010, Block Group 2, Census Tract 30, Fayette County, Kentucky",74,72,2
1000000US210670030002011,210670030002011,"Block 2011, Block Group 2, Census Tract 30, Fayette County, Kentucky",0,0,0
1000000US210670030003000,210670030003000,"Block 3000, Block Group 3, Census Tract 30, Fayette County, Kentucky",51,49,2
1000000US210670030003001,210670030003001,"Block 3001, Block Group 3, Census Tract 30, Fayette County, Kentucky",14,13,1
1000000US210670030003002,210670030003002,"Block 3002, Block Group 3, Census Tract 30, Fayette County, Kentucky",16,15,1
1000000US210670030003003,210670030003003,"Block 3003, Block Group 3, Census Tract 30, Fayette County, Kentucky",29,28,1
1000000US210670030003004,210670030003004,"Block 3004, Block Group 3, Census Tract 30, Fayette County, Kentucky",84,83,1
1000000US210670030003005,210670030003005,"Block 3005, Block Group 3, Census Tract 30, Fayette County, Kentucky",234,219,15
1000000US210670030003006,210670030003006,"Block 3006, Block Group 3, Census Tract 30, Fayette County, Kentucky",59,56,3
1000000US210670030003007,210670030003007,"Block 3007, Block Group 3, Census Tract 30, Fayette County, Kentucky",35,35,0
1000000US210670030003008,210670030003008,"Block 3008, Block Group 3, Census Tract 30, Fayette County, Kentucky",47,44,3
1000000US210670030004000,210670030004000,"Block 4000, Block Group 4, Census Tract 30, Fayette County, Kentucky",0,0,0
1000000US210670030004001,210670030004001,"Block 4001, Block Group 4, Census Tract 30, Fayette County, Kentucky",10,10,0
1000000US210670030004002,210670030004002,"Block 4002, Block Group 4, Census Tract 30, Fayette County, Kentucky",17,17,0
1000000US210670030004003,210670030004003,"Block 4003, Block Group 4, Census Tract 30, Fayette County, Kentucky",6,6,0
1000000US210670030004004,210670030004004,"Block 4004, Block Group 4, Census Tract 30, Fayette County, Kentucky",14,13,1
1000000US210670030004005,210670030004005,"Block 4005, Block Group 4, Census Tract 30, Fayette County, Kentucky",14,14,0
1000000US210670030004006,210670030004006,"Block 4006, Block Group 4, Census Tract 30, Fayette County, Kentucky",40,38,2
1000000US210670030004007,210670030004007,"Block 4007, Block Group 4, Census Tract 30, Fayette County, Kentucky",48,47,1
1000000US210670030004008,210670030004008,"Block 4008, Block Group 4, Census Tract 30, Fayette County, Kentucky",27,26,1
1000000US210670030004009,210670030004009,"Block 4009, Block Group 4, Census Tract 30, Fayette County, Kentucky",29,28,1
1000000US210670030004010,210670030004010,"Block 4010, Block Group 4, Census Tract 30, Fayette County, Kentucky",54,53,1
1000000US210670030004011,210670030004011,"Block 4011, Block Group 4, Census Tract 30, Fayette County, Kentucky",0,0,0
1000000US210670030004012,210670030004012,"Block 4012, Block Group 4, Census Tract 30, Fayette County, Kentucky",0,0,0
1000000US210670030004013,210670030004013,"Block 4013, Block Group 4, Census Tract 30, Fayette County, Kentucky",11,10,1
1000000US210670030004014,210670030004014,"Block 4014, Block Group 4, Census Tract 30, Fayette County, Kentucky",42,41,1
1000000US210670030004015,210670030004015,"Block 4015, Block Group 4, Census Tract 30, Fayette County, Kentucky",0,0,0
1000000US210670030004016,210670030004016,"Block 4016, Block Group 4, Census Tract 30, Fayette County, Kentucky",6,6,0
1000000US210670030005000,210670030005000,"Block 5000, Block Group 5, Census Tract 30, Fayette County, Kentucky",199,186,13
1000000US210670030005001,210670030005001,"Block 5001, Block Group 5, Census Tract 30, Fayette County, Kentucky",6,6,0
1000000US210670030005002,210670030005002,"Block 5002, Block Group 5, Census Tract 30, Fayette County, Kentucky",79,73,6
1000000US210670030005003,210670030005003,"Block 5003, Block Group 5, Census Tract 30, Fayette County, Kentucky",2,1,1
1000000US210670030005004,210670030005004,"Block 5004, Block Group 5, Census Tract 30, Fayette County, Kentucky",13,12,1
1000000US210670030005005,210670030005005,"Block 5005, Block Group 5, Census Tract 30, Fayette County, Kentucky",16,14,2
1000000US210670030005006,210670030005006,"Block 5006, Block Group 5, Census Tract 30, Fayette County, Kentucky",44,44,0
1000000US210670030005007,210670030005007,"Block 5007, Block Group 5, Census Tract 30, Fayette County, Kentucky",67,65,2
1000000US210670030005008,210670030005008,"Block 5008, Block Group 5, Census Tract 30, Fayette County, Kentucky",28,27,1
1000000US210670030005009,210670030005009,"Block 5009, Block Group 5, Census Tract 30, Fayette County, Kentucky",0,0,0
1000000US210670030005010,210670030005010,"Block 5010, Block Group 5, Census Tract 30, Fayette County, Kentucky",15,15,0
1000000US210670030005011,210670030005011,"Block 5011, Block Group 5, Census Tract 30, Fayette County, Kentucky",12,11,1
1000000US210670030005012,210670030005012,"Block 5012, Block Group 5, Census Tract 30, Fayette County, Kentucky",33,33,0
1000000US210670030005013,210670030005013,"Block 5013, Block Group 5, Census Tract 30, Fayette County, Kentucky",34,34,0
1000000US210670030005014,210670030005014,"Block 5014, Block Group 5, Census Tract 30, Fayette County, Kentucky",3,1,2
1000000US210670031011000,210670031011000,"Block 1000, Block Group 1, Census Tract 31.01, Fayette County, Kentucky",111,108,3
1000000US210670031011001,210670031011001,"Block 1001, Block Group 1, Census Tract 31.01, Fayette County, Kentucky",44,44,0
1000000US210670031011002,210670031011002,"Block 1002, Block Group 1, Census Tract 31.01, Fayette County, Kentucky",34,34,0
1000000US210670031011003,210670031011003,"Block 1003, Block Group 1, Census Tract 31.01, Fayette County, Kentucky",166,158,8
1000000US210670031011004,210670031011004,"Block 1004, Block Group 1, Census Tract 31.01, Fayette County, Kentucky",31,31,0
1000000US210670031011005,210670031011005,"Block 1005, Block Group 1, Census Tract 31.01, Fayette County, Kentucky",31,31,0
1000000US210670031011006,210670031011006,"Block 1006, Block Group 1, Census Tract 31.01, Fayette County, Kentucky",25,25,0
1000000US210670031011007,210670031011007,"Block 1007, Block Group 1, Census Tract 31.01, Fayette County, Kentucky",73,72,1
1000000US210670031011008,210670031011008,"Block 1008, Block Group 1, Census Tract 31.01, Fayette County, Kentucky",35,35,0
1000000US210670031011009,210670031011009,"Block 1009, Block Group 1, Census Tract 31.01, Fayette County, Kentucky",28,28,0
1000000US210670031011010,210670031011010,"Block 1010, Block Group 1, Census Tract 31.01, Fayette County, Kentucky",10,9,1
1000000US210670031012000,210670031012000,"Block 2000, Block Group 2, Census Tract 31.01, Fayette County, Kentucky",38,38,0
1000000US210670031012001,210670031012001,"Block 2001, Block Group 2, Census Tract 31.01, Fayette County, Kentucky",191,190,1
1000000US210670031012002,210670031012002,"Block 2002, Block Group 2, Census Tract 31.01, Fayette County, Kentucky",46,45,1
1000000US210670031012003,210670031012003,"Block 2003, Block Group 2, Census Tract 31.01, Fayette County, Kentucky",134,132,2
1000000US210670031012004,210670031012004,"Block 2004, Block Group 2, Census Tract 31.01, Fayette County, Kentucky",17,17,0
1000000US210670031012005,210670031012005,"Block 2005, Block Group 2, Census Tract 31.01, Fayette County, Kentucky",42,41,1
1000000US210670031012006,210670031012006,"Block 2006, Block Group 2, Census Tract 31.01, Fayette County, Kentucky",26,26,0
1000000US210670031012007,210670031012007,"Block 2007, Block Group 2, Census Tract 31.01, Fayette County, Kentucky",17,17,0
1000000US210670031012008,210670031012008,"Block 2008, Block Group 2, Census Tract 31.01, Fayette County, Kentucky",34,32,2
1000000US210670031012009,210670031012009,"Block 2009, Block Group 2, Census Tract 31.01, Fayette County, Kentucky",50,48,2
1000000US210670031012010,210670031012010,"Block 2010, Block Group 2, Census Tract 31.01, Fayette County, Kentucky",30,27,3
1000000US210670031012011,210670031012011,"Block 2011, Block Group 2, Census Tract 31.01, Fayette County, Kentucky",23,23,0
1000000US210670031012012,210670031012012,"Block 2012, Block Group 2, Census Tract 31.01, Fayette County, Kentucky",18,18,0
1000000US210670031012013,210670031012013,"Block 2013, Block Group 2, Census Tract 31.01, Fayette County, Kentucky",13,13,0
1000000US210670031012014,210670031012014,"Block 2014, Block Group 2, Census Tract 31.01, Fayette County, Kentucky",0,0,0
1000000US210670031021000,210670031021000,"Block 1000, Block Group 1, Census Tract 31.02, Fayette County, Kentucky",11,11,0
1000000US210670031021001,210670031021001,"Block 1001, Block Group 1, Census Tract 31.02, Fayette County, Kentucky",18,18,0
1000000US210670031021002,210670031021002,"Block 1002, Block Group 1, Census Tract 31.02, Fayette County, Kentucky",11,11,0
1000000US210670031021003,210670031021003,"Block 1003, Block Group 1, Census Tract 31.02, Fayette County, Kentucky",88,87,1
1000000US210670031021004,210670031021004,"Block 1004, Block Group 1, Census Tract 31.02, Fayette County, Kentucky",36,36,0
1000000US210670031021005,210670031021005,"Block 1005, Block Group 1, Census Tract 31.02, Fayette County, Kentucky",36,34,2
1000000US210670031021006,210670031021006,"Block 1006, Block Group 1, Census Tract 31.02, Fayette County, Kentucky",28,27,1
1000000US210670031021007,210670031021007,"Block 1007, Block Group 1, Census Tract 31.02, Fayette County, Kentucky",103,98,5
1000000US210670031021008,210670031021008,"Block 1008, Block Group 1, Census Tract 31.02, Fayette County, Kentucky",79,77,2
1000000US210670031021009,210670031021009,"Block 1009, Block Group 1, Census Tract 31.02, Fayette County, Kentucky",0,0,0
1000000US210670031021010,210670031021010,"Block 1010, Block Group 1, Census Tract 31.02, Fayette County, Kentucky",22,19,3
1000000US210670031021011,210670031021011,"Block 1011, Block Group 1, Census Tract 31.02, Fayette County, Kentucky",25,25,0
1000000US210670031021012,210670031021012,"Block 1012, Block Group 1, Census Tract 31.02, Fayette County, Kentucky",69,69,0
1000000US210670031021013,210670031021013,"Block 1013, Block Group 1, Census Tract 31.02, Fayette County, Kentucky",31,30,1
1000000US210670031021014,210670031021014,"Block 1014, Block Group 1, Census Tract 31.02, Fayette County, Kentucky",40,39,1
1000000US210670031021015,210670031021015,"Block 1015, Block Group 1, Census Tract 31.02, Fayette County, Kentucky",54,53,1
1000000US210670031021016,210670031021016,"Block 1016, Block Group 1, Census Tract 31.02, Fayette County, Kentucky",27,27,0
1000000US210670031021017,210670031021017,"Block 1017, Block Group 1, Census Tract 31.02, Fayette County, Kentucky",35,35,0
1000000US210670031022000,210670031022000,"Block 2000, Block Group 2, Census Tract 31.02, Fayette County, Kentucky",0,0,0
1000000US210670031022001,210670031022001,"Block 2001, Block Group 2, Census Tract 31.02, Fayette County, Kentucky",0,0,0
1000000US210670031022002,210670031022002,"Block 2002, Block Group 2, Census Tract 31.02, Fayette County, Kentucky",0,0,0
1000000US210670031022003,210670031022003,"Block 2003, Block Group 2, Census Tract 31.02, Fayette County, Kentucky",0,0,0
1000000US210670031022004,210670031022004,"Block 2004, Block Group 2, Census Tract 31.02, Fayette County, Kentucky",24,24,0
1000000US210670031022005,210670031022005,"Block 2005, Block Group 2, Census Tract 31.02, Fayette County, Kentucky",18,18,0
1000000US210670031022006,210670031022006,"Block 2006, Block Group 2, Census Tract 31.02, Fayette County, Kentucky",32,31,1
1000000US210670031022007,210670031022007,"Block 2007, Block Group 2, Census Tract 31.02, Fayette County, Kentucky",27,27,0
1000000US210670031022008,210670031022008,"Block 2008, Block Group 2, Census Tract 31.02, Fayette County, Kentucky",61,60,1
1000000US210670031022009,210670031022009,"Block 2009, Block Group 2, Census Tract 31.02, Fayette County, Kentucky",2,2,0
1000000US210670031022010,210670031022010,"Block 2010, Block Group 2, Census Tract 31.02, Fayette County, Kentucky",43,41,2
1000000US210670031022011,210670031022011,"Block 2011, Block Group 2, Census Tract 31.02, Fayette County, Kentucky",0,0,0
1000000US210670031022012,210670031022012,"Block 2012, Block Group 2, Census Tract 31.02, Fayette County, Kentucky",24,23,1
1000000US210670031022013,210670031022013,"Block 2013, Block Group 2, Census Tract 31.02, Fayette County, Kentucky",11,11,0
1000000US210670031022014,210670031022014,"Block 2014, Block Group 2, Census Tract 31.02, Fayette County, Kentucky",23,23,0
1000000US210670031022015,210670031022015,"Block 2015, Block Group 2, Census Tract 31.02, Fayette County, Kentucky",18,17,1
1000000US210670031022016,210670031022016,"Block 2016, Block Group 2, Census Tract 31.02, Fayette County, Kentucky",20,19,1
1000000US210670031022017,210670031022017,"Block 2017, Block Group 2, Census Tract 31.02, Fayette County, Kentucky",0,0,0
1000000US210670031022018,210670031022018,"Block 2018, Block Group 2, Census Tract 31.02, Fayette County, Kentucky",25,25,0
1000000US210670031022019,210670031022019,"Block 2019, Block Group 2, Census Tract 31.02, Fayette County, Kentucky",0,0,0
1000000US210670031022020,210670031022020,"Block 2020, Block Group 2, Census Tract 31.02, Fayette County, Kentucky",19,18,1
1000000US210670031022021,210670031022021,"Block 2021, Block Group 2, Census Tract 31.02, Fayette County, Kentucky",0,0,0
1000000US210670031022022,210670031022022,"Block 2022, Block Group 2, Census Tract 31.02, Fayette County, Kentucky",0,0,0
1000000US210670031022023,210670031022023,"Block 2023, Block Group 2, Census Tract 31.02, Fayette County, Kentucky",20,20,0
1000000US210670031022024,210670031022024,"Block 2024, Block Group 2, Census Tract 31.02, Fayette County, Kentucky",0,0,0
1000000US210670031022025,210670031022025,"Block 2025, Block Group 2, Census Tract 31.02, Fayette County, Kentucky",0,0,0
1000000US210670031022026,210670031022026,"Block 2026, Block Group 2, Census Tract 31.02, Fayette County, Kentucky",0,0,0
1000000US210670031022027,210670031022027,"Block 2027, Block Group 2, Census Tract 31.02, Fayette County, Kentucky",0,0,0
1000000US210670032001000,210670032001000,"Block 1000, Block Group 1, Census Tract 32, Fayette County, Kentucky",36,36,0
1000000US210670032001001,210670032001001,"Block 1001, Block Group 1, Census Tract 32, Fayette County, Kentucky",18,15,3
1000000US210670032001002,210670032001002,"Block 1002, Block Group 1, Census Tract 32, Fayette County, Kentucky",65,65,0
1000000US210670032001003,210670032001003,"Block 1003, Block Group 1, Census Tract 32, Fayette County, Kentucky",34,34,0
1000000US210670032001004,210670032001004,"Block 1004, Block Group 1, Census Tract 32, Fayette County, Kentucky",40,39,1
1000000US210670032001005,210670032001005,"Block 1005, Block Group 1, Census Tract 32, Fayette County, Kentucky",0,0,0
1000000US210670032001006,210670032001006,"Block 1006, Block Group 1, Census Tract 32, Fayette County, Kentucky",26,26,0
1000000US210670032001007,210670032001007,"Block 1007, Block Group 1, Census Tract 32, Fayette County, Kentucky",19,18,1
1000000US210670032001008,210670032001008,"Block 1008, Block Group 1, Census Tract 32, Fayette County, Kentucky",37,37,0
1000000US210670032001009,210670032001009,"Block 1009, Block Group 1, Census Tract 32, Fayette County, Kentucky",88,87,1
1000000US210670032001010,210670032001010,"Block 1010, Block Group 1, Census Tract 32, Fayette County, Kentucky",60,58,2
1000000US210670032001011,210670032001011,"Block 1011, Block Group 1, Census Tract 32, Fayette County, Kentucky",59,59,0
1000000US210670032001012,210670032001012,"Block 1012, Block Group 1, Census Tract 32, Fayette County, Kentucky",21,21,0
1000000US210670032001013,210670032001013,"Block 1013, Block Group 1, Census Tract 32, Fayette County, Kentucky",65,64,1
1000000US210670032001014,210670032001014,"Block 1014, Block Group 1, Census Tract 32, Fayette County, Kentucky",42,42,0
1000000US210670032001015,210670032001015,"Block 1015, Block Group 1, Census Tract 32, Fayette County, Kentucky",34,34,0
1000000US210670032001016,210670032001016,"Block 1016, Block Group 1, Census Tract 32, Fayette County, Kentucky",28,27,1
1000000US210670032001017,210670032001017,"Block 1017, Block Group 1, Census Tract 32, Fayette County, Kentucky",198,170,28
1000000US210670032001018,210670032001018,"Block 1018, Block Group 1, Census Tract 32, Fayette County, Kentucky",71,66,5
1000000US210670032001019,210670032001019,"Block 1019, Block Group 1, Census Tract 32, Fayette County, Kentucky",34,34,0
1000000US210670032001020,210670032001020,"Block 1020, Block Group 1, Census Tract 32, Fayette County, Kentucky",32,31,1
1000000US210670032001021,210670032001021,"Block 1021, Block Group 1, Census Tract 32, Fayette County, Kentucky",50,47,3
1000000US210670032001022,210670032001022,"Block 1022, Block Group 1, Census Tract 32, Fayette County, Kentucky",58,56,2
1000000US210670032001023,210670032001023,"Block 1023, Block Group 1, Census Tract 32, Fayette County, Kentucky",101,66,35
1000000US210670032001024,210670032001024,"Block 1024, Block Group 1, Census Tract 32, Fayette County, Kentucky",128,118,10
1000000US210670032002000,210670032002000,"Block 2000, Block Group 2, Census Tract 32, Fayette County, Kentucky",190,174,16
1000000US210670032002001,210670032002001,"Block 2001, Block Group 2, Census Tract 32, Fayette County, Kentucky",30,29,1
1000000US210670032002002,210670032002002,"Block 2002, Block Group 2, Census Tract 32, Fayette County, Kentucky",57,56,1
1000000US210670032002003,210670032002003,"Block 2003, Block Group 2, Census Tract 32, Fayette County, Kentucky",187,182,5
1000000US210670032002004,210670032002004,"Block 2004, Block Group 2, Census Tract 32, Fayette County, Kentucky",17,17,0
1000000US210670032002005,210670032002005,"Block 2005, Block Group 2, Census Tract 32, Fayette County, Kentucky",28,28,0
1000000US210670032002006,210670032002006,"Block 2006, Block Group 2, Census Tract 32, Fayette County, Kentucky",83,81,2
1000000US210670032002007,210670032002007,"Block 2007, Block Group 2, Census Tract 32, Fayette County, Kentucky",96,95,1
1000000US210670032002008,210670032002008,"Block 2008, Block Group 2, Census Tract 32, Fayette County, Kentucky",21,20,1
1000000US210670032002009,210670032002009,"Block 2009, Block Group 2, Census Tract 32, Fayette County, Kentucky",51,51,0
1000000US210670032002010,210670032002010,"Block 2010, Block Group 2, Census Tract 32, Fayette County, Kentucky",19,17,2
1000000US210670032002011,210670032002011,"Block 2011, Block Group 2, Census Tract 32, Fayette County, Kentucky",28,28,0
1000000US210670032002012,210670032002012,"Block 2012, Block Group 2, Census Tract 32, Fayette County, Kentucky",38,37,1
1000000US210670032002013,210670032002013,"Block 2013, Block Group 2, Census Tract 32, Fayette County, Kentucky",31,31,0
1000000US210670032002014,210670032002014,"Block 2014, Block Group 2, Census Tract 32, Fayette County, Kentucky",33,32,1
1000000US210670032002015,210670032002015,"Block 2015, Block Group 2, Census Tract 32, Fayette County, Kentucky",32,32,0
1000000US210670032002016,210670032002016,"Block 2016, Block Group 2, Census Tract 32, Fayette County, Kentucky",31,31,0
1000000US210670032002017,210670032002017,"Block 2017, Block Group 2, Census Tract 32, Fayette County, Kentucky",25,23,2
1000000US210670032002018,210670032002018,"Block 2018, Block Group 2, Census Tract 32, Fayette County, Kentucky",18,18,0
1000000US210670032002019,210670032002019,"Block 2019, Block Group 2, Census Tract 32, Fayette County, Kentucky",48,48,0
1000000US210670032002020,210670032002020,"Block 2020, Block Group 2, Census Tract 32, Fayette County, Kentucky",19,19,0
1000000US210670032002021,210670032002021,"Block 2021, Block Group 2, Census Tract 32, Fayette County, Kentucky",51,51,0
1000000US210670032002022,210670032002022,"Block 2022, Block Group 2, Census Tract 32, Fayette County, Kentucky",14,13,1
1000000US210670032002023,210670032002023,"Block 2023, Block Group 2, Census Tract 32, Fayette County, Kentucky",14,14,0
1000000US210670032002024,210670032002024,"Block 2024, Block Group 2, Census Tract 32, Fayette County, Kentucky",574,529,45
1000000US210670032002025,210670032002025,"Block 2025, Block Group 2, Census Tract 32, Fayette County, Kentucky",6,6,0
1000000US210670032003000,210670032003000,"Block 3000, Block Group 3, Census Tract 32, Fayette County, Kentucky",240,233,7
1000000US210670032003001,210670032003001,"Block 3001, Block Group 3, Census Tract 32, Fayette County, Kentucky",41,41,0
1000000US210670032003002,210670032003002,"Block 3002, Block Group 3, Census Tract 32, Fayette County, Kentucky",6,6,0
1000000US210670032003003,210670032003003,"Block 3003, Block Group 3, Census Tract 32, Fayette County, Kentucky",69,55,14
1000000US210670032003004,210670032003004,"Block 3004, Block Group 3, Census Tract 32, Fayette County, Kentucky",58,55,3
1000000US210670032003005,210670032003005,"Block 3005, Block Group 3, Census Tract 32, Fayette County, Kentucky",4,4,0
1000000US210670032003006,210670032003006,"Block 3006, Block Group 3, Census Tract 32, Fayette County, Kentucky",9,9,0
1000000US210670032003007,210670032003007,"Block 3007, Block Group 3, Census Tract 32, Fayette County, Kentucky",15,13,2
1000000US210670032003008,210670032003008,"Block 3008, Block Group 3, Census Tract 32, Fayette County, Kentucky",31,28,3
1000000US210670032003009,210670032003009,"Block 3009, Block Group 3, Census Tract 32, Fayette County, Kentucky",4,4,0
1000000US210670032003010,210670032003010,"Block 3010, Block Group 3, Census Tract 32, Fayette County, Kentucky",13,13,0
1000000US210670032003011,210670032003011,"Block 3011, Block Group 3, Census Tract 32, Fayette County, Kentucky",5,5,0
1000000US210670032003012,210670032003012,"Block 3012, Block Group 3, Census Tract 32, Fayette County, Kentucky",25,25,0
1000000US210670032003013,210670032003013,"Block 3013, Block Group 3, Census Tract 32, Fayette County, Kentucky",38,37,1
1000000US210670032003014,210670032003014,"Block 3014, Block Group 3, Census Tract 32, Fayette County, Kentucky",71,71,0
1000000US210670032003015,210670032003015,"Block 3015, Block Group 3, Census Tract 32, Fayette County, Kentucky",28,28,0
1000000US210670032003016,210670032003016,"Block 3016, Block Group 3, Census Tract 32, Fayette County, Kentucky",0,0,0
1000000US210670032003017,210670032003017,"Block 3017, Block Group 3, Census Tract 32, Fayette County, Kentucky",13,13,0
1000000US210670033001000,210670033001000,"Block 1000, Block Group 1, Census Tract 33, Fayette County, Kentucky",0,0,0
1000000US210670033001001,210670033001001,"Block 1001, Block Group 1, Census Tract 33, Fayette County, Kentucky",1,1,0
1000000US210670033001002,210670033001002,"Block 1002, Block Group 1, Census Tract 33, Fayette County, Kentucky",0,0,0
1000000US210670033001003,210670033001003,"Block 1003, Block Group 1, Census Tract 33, Fayette County, Kentucky",1,1,0
1000000US210670033001004,210670033001004,"Block 1004, Block Group 1, Census Tract 33, Fayette County, Kentucky",64,63,1
1000000US210670033001005,210670033001005,"Block 1005, Block Group 1, Census Tract 33, Fayette County, Kentucky",9,8,1
1000000US210670033001006,210670033001006,"Block 1006, Block Group 1, Census Tract 33, Fayette County, Kentucky",30,30,0
1000000US210670033001007,210670033001007,"Block 1007, Block Group 1, Census Tract 33, Fayette County, Kentucky",12,12,0
1000000US210670033001008,210670033001008,"Block 1008, Block Group 1, Census Tract 33, Fayette County, Kentucky",16,16,0
1000000US210670033001009,210670033001009,"Block 1009, Block Group 1, Census Tract 33, Fayette County, Kentucky",6,6,0
1000000US210670033001010,210670033001010,"Block 1010, Block Group 1, Census Tract 33, Fayette County, Kentucky",16,16,0
1000000US210670033001011,210670033001011,"Block 1011, Block Group 1, Census Tract 33, Fayette County, Kentucky",31,30,1
1000000US210670033001012,210670033001012,"Block 1012, Block Group 1, Census Tract 33, Fayette County, Kentucky",373,343,30
1000000US210670033001013,210670033001013,"Block 1013, Block Group 1, Census Tract 33, Fayette County, Kentucky",8,8,0
1000000US210670033001014,210670033001014,"Block 1014, Block Group 1, Census Tract 33, Fayette County, Kentucky",16,16,0
1000000US210670033001015,210670033001015,"Block 1015, Block Group 1, Census Tract 33, Fayette County, Kentucky",13,13,0
1000000US210670033001016,210670033001016,"Block 1016, Block Group 1, Census Tract 33, Fayette County, Kentucky",8,8,0
1000000US210670033001017,210670033001017,"Block 1017, Block Group 1, Census Tract 33, Fayette County, Kentucky",11,10,1
1000000US210670033001018,210670033001018,"Block 1018, Block Group 1, Census Tract 33, Fayette County, Kentucky",17,13,4
1000000US210670033001019,210670033001019,"Block 1019, Block Group 1, Census Tract 33, Fayette County, Kentucky",7,7,0
1000000US210670033001020,210670033001020,"Block 1020, Block Group 1, Census Tract 33, Fayette County, Kentucky",9,9,0
1000000US210670033001021,210670033001021,"Block 1021, Block Group 1, Census Tract 33, Fayette County, Kentucky",7,7,0
1000000US210670033001022,210670033001022,"Block 1022, Block Group 1, Census Tract 33, Fayette County, Kentucky",10,10,0
1000000US210670033001023,210670033001023,"Block 1023, Block Group 1, Census Tract 33, Fayette County, Kentucky",117,110,7
1000000US210670033001024,210670033001024,"Block 1024, Block Group 1, Census Tract 33, Fayette County, Kentucky",138,132,6
1000000US210670033001025,210670033001025,"Block 1025, Block Group 1, Census Tract 33, Fayette County, Kentucky",20,20,0
1000000US210670033001026,210670033001026,"Block 1026, Block Group 1, Census Tract 33, Fayette County, Kentucky",0,0,0
1000000US210670033001027,210670033001027,"Block 1027, Block Group 1, Census Tract 33, Fayette County, Kentucky",1,1,0
1000000US210670033001028,210670033001028,"Block 1028, Block Group 1, Census Tract 33, Fayette County, Kentucky",0,0,0
1000000US210670033001029,210670033001029,"Block 1029, Block Group 1, Census Tract 33, Fayette County, Kentucky",10,10,0
1000000US210670033001030,210670033001030,"Block 1030, Block Group 1, Census Tract 33, Fayette County, Kentucky",13,12,1
1000000US210670033001031,210670033001031,"Block 1031, Block Group 1, Census Tract 33, Fayette County, Kentucky",1,1,0
1000000US210670033001032,210670033001032,"Block 1032, Block Group 1, Census Tract 33, Fayette County, Kentucky",0,0,0
1000000US210670033001033,210670033001033,"Block 1033, Block Group 1, Census Tract 33, Fayette County, Kentucky",0,0,0
1000000US210670033001034,210670033001034,"Block 1034, Block Group 1, Census Tract 33, Fayette County, Kentucky",12,12,0
1000000US210670033001035,210670033001035,"Block 1035, Block Group 1, Census Tract 33, Fayette County, Kentucky",15,13,2
1000000US210670033001036,210670033001036,"Block 1036, Block Group 1, Census Tract 33, Fayette County, Kentucky",24,23,1
1000000US210670033001037,210670033001037,"Block 1037, Block Group 1, Census Tract 33, Fayette County, Kentucky",29,29,0
1000000US210670033001038,210670033001038,"Block 1038, Block Group 1, Census Tract 33, Fayette County, Kentucky",18,17,1
1000000US210670033001039,210670033001039,"Block 1039, Block Group 1, Census Tract 33, Fayette County, Kentucky",12,12,0
1000000US210670033001040,210670033001040,"Block 1040, Block Group 1, Census Tract 33, Fayette County, Kentucky",16,15,1
1000000US210670034021000,210670034021000,"Block 1000, Block Group 1, Census Tract 34.02, Fayette County, Kentucky",0,0,0
1000000US210670034021001,210670034021001,"Block 1001, Block Group 1, Census Tract 34.02, Fayette County, Kentucky",278,219,59
1000000US210670034021002,210670034021002,"Block 1002, Block Group 1, Census Tract 34.02, Fayette County, Kentucky",253,247,6
1000000US210670034021003,210670034021003,"Block 1003, Block Group 1, Census Tract 34.02, Fayette County, Kentucky",37,35,2
1000000US210670034021004,210670034021004,"Block 1004, Block Group 1, Census Tract 34.02, Fayette County, Kentucky",193,179,14
1000000US210670034021005,210670034021005,"Block 1005, Block Group 1, Census Tract 34.02, Fayette County, Kentucky",12,11,1
1000000US210670034021006,210670034021006,"Block 1006, Block Group 1, Census Tract 34.02, Fayette County, Kentucky",23,21,2
1000000US210670034021007,210670034021007,"Block 1007, Block Group 1, Census Tract 34.02, Fayette County, Kentucky",10,9,1
1000000US210670034021008,210670034021008,"Block 1008, Block Group 1, Census Tract 34.02, Fayette County, Kentucky",26,26,0
1000000US210670034021009,210670034021009,"Block 1009, Block Group 1, Census Tract 34.02, Fayette County, Kentucky",4,4,0
1000000US210670034021010,210670034021010,"Block 1010, Block Group 1, Census Tract 34.02, Fayette County, Kentucky",6,6,0
1000000US210670034021011,210670034021011,"Block 1011, Block Group 1, Census Tract 34.02, Fayette County, Kentucky",10,10,0
1000000US210670034021012,210670034021012,"Block 1012, Block Group 1, Census Tract 34.02, Fayette County, Kentucky",94,88,6
1000000US210670034021013,210670034021013,"Block 1013, Block Group 1, Census Tract 34.02, Fayette County, Kentucky",143,132,11
1000000US210670034021014,210670034021014,"Block 1014, Block Group 1, Census Tract 34.02, Fayette County, Kentucky",82,75,7
1000000US210670034021015,210670034021015,"Block 1015, Block Group 1, Census Tract 34.02, Fayette County, Kentucky",24,24,0
1000000US210670034021016,210670034021016,"Block 1016, Block Group 1, Census Tract 34.02, Fayette County, Kentucky",46,43,3
1000000US210670034021017,210670034021017,"Block 1017, Block Group 1, Census Tract 34.02, Fayette County, Kentucky",71,71,0
1000000US210670034022000,210670034022000,"Block 2000, Block Group 2, Census Tract 34.02, Fayette County, Kentucky",0,0,0
1000000US210670034022001,210670034022001,"Block 2001, Block Group 2, Census Tract 34.02, Fayette County, Kentucky",36,33,3
1000000US210670034022002,210670034022002,"Block 2002, Block Group 2, Census Tract 34.02, Fayette County, Kentucky",432,398,34
1000000US210670034022003,210670034022003,"Block 2003, Block Group 2, Census Tract 34.02, Fayette County, Kentucky",26,23,3
1000000US210670034022004,210670034022004,"Block 2004, Block Group 2, Census Tract 34.02, Fayette County, Kentucky",228,211,17
1000000US210670034022005,210670034022005,"Block 2005, Block Group 2, Census Tract 34.02, Fayette County, Kentucky",63,60,3
1000000US210670034022006,210670034022006,"Block 2006, Block Group 2, Census Tract 34.02, Fayette County, Kentucky",30,29,1
1000000US210670034022007,210670034022007,"Block 2007, Block Group 2, Census Tract 34.02, Fayette County, Kentucky",19,18,1
1000000US210670034022008,210670034022008,"Block 2008, Block Group 2, Census Tract 34.02, Fayette County, Kentucky",69,67,2
1000000US210670034022009,210670034022009,"Block 2009, Block Group 2, Census Tract 34.02, Fayette County, Kentucky",23,21,2
1000000US210670034022010,210670034022010,"Block 2010, Block Group 2, Census Tract 34.02, Fayette County, Kentucky",25,25,0
1000000US210670034022011,210670034022011,"Block 2011, Block Group 2, Census Tract 34.02, Fayette County, Kentucky",34,34,0
1000000US210670034022012,210670034022012,"Block 2012, Block Group 2, Census Tract 34.02, Fayette County, Kentucky",25,25,0
1000000US210670034022013,210670034022013,"Block 2013, Block Group 2, Census Tract 34.02, Fayette County, Kentucky",16,15,1
1000000US210670034041000,210670034041000,"Block 1000, Block Group 1, Census Tract 34.04, Fayette County, Kentucky",898,762,136
1000000US210670034041001,210670034041001,"Block 1001, Block Group 1, Census Tract 34.04, Fayette County, Kentucky",13,12,1
1000000US210670034041002,210670034041002,"Block 1002, Block Group 1, Census Tract 34.04, Fayette County, Kentucky",20,20,0
1000000US210670034041003,210670034041003,"Block 1003, Block Group 1, Census Tract 34.04, Fayette County, Kentucky",22,21,1
1000000US210670034041004,210670034041004,"Block 1004, Block Group 1, Census Tract 34.04, Fayette County, Kentucky",45,43,2
1000000US210670034041005,210670034041005,"Block 1005, Block Group 1, Census Tract 34.04, Fayette County, Kentucky",63,63,0
1000000US210670034041006,210670034041006,"Block 1006, Block Group 1, Census Tract 34.04, Fayette County, Kentucky",0,0,0
1000000US210670034041007,210670034041007,"Block 1007, Block Group 1, Census Tract 34.04, Fayette County, Kentucky",24,24,0
1000000US210670034041008,210670034041008,"Block 1008, Block Group 1, Census Tract 34.04, Fayette County, Kentucky",16,15,1
1000000US210670034041009,210670034041009,"Block 1009, Block Group 1, Census Tract 34.04, Fayette County, Kentucky",28,27,1
1000000US210670034042000,210670034042000,"Block 2000, Block Group 2, Census Tract 34.04, Fayette County, Kentucky",103,101,2
1000000US210670034042001,210670034042001,"Block 2001, Block Group 2, Census Tract 34.04, Fayette County, Kentucky",16,16,0
1000000US210670034042002,210670034042002,"Block 2002, Block Group 2, Census Tract 34.04, Fayette County, Kentucky",26,24,2
1000000US210670034042003,210670034042003,"Block 2003, Block Group 2, Census Tract 34.04, Fayette County, Kentucky",57,56,1
1000000US210670034042004,210670034042004,"Block 2004, Block Group 2, Census Tract 34.04, Fayette County, Kentucky",51,51,0
1000000US210670034042005,210670034042005,"Block 2005, Block Group 2, Census Tract 34.04, Fayette County, Kentucky",23,23,0
1000000US210670034042006,210670034042006,"Block 2006, Block Group 2, Census Tract 34.04, Fayette County, Kentucky",56,54,2
1000000US210670034042007,210670034042007,"Block 2007, Block Group 2, Census Tract 34.04, Fayette County, Kentucky",8,7,1
1000000US210670034042008,210670034042008,"Block 2008, Block Group 2, Census Tract 34.04, Fayette County, Kentucky",25,24,1
1000000US210670034042009,210670034042009,"Block 2009, Block Group 2, Census Tract 34.04, Fayette County, Kentucky",30,28,2
1000000US210670034042010,210670034042010,"Block 2010, Block Group 2, Census Tract 34.04, Fayette County, Kentucky",17,17,0
1000000US210670034042011,210670034042011,"Block 2011, Block Group 2, Census Tract 34.04, Fayette County, Kentucky",48,47,1
1000000US210670034042012,210670034042012,"Block 2012, Block Group 2, Census Tract 34.04, Fayette County, Kentucky",21,21,0
1000000US210670034042013,210670034042013,"Block 2013, Block Group 2, Census Tract 34.04, Fayette County, Kentucky",20,18,2
1000000US210670034042014,210670034042014,"Block 2014, Block Group 2, Census Tract 34.04, Fayette County, Kentucky",23,22,1
1000000US210670034042015,210670034042015,"Block 2015, Block Group 2, Census Tract 34.04, Fayette County, Kentucky",24,24,0
1000000US210670034042016,210670034042016,"Block 2016, Block Group 2, Census Tract 34.04, Fayette County, Kentucky",30,30,0
1000000US210670034043000,210670034043000,"Block 3000, Block Group 3, Census Tract 34.04, Fayette County, Kentucky",197,192,5
1000000US210670034043001,210670034043001,"Block 3001, Block Group 3, Census Tract 34.04, Fayette County, Kentucky",80,77,3
1000000US210670034051000,210670034051000,"Block 1000, Block Group 1, Census Tract 34.05, Fayette County, Kentucky",56,56,0
1000000US210670034051001,210670034051001,"Block 1001, Block Group 1, Census Tract 34.05, Fayette County, Kentucky",88,87,1
1000000US210670034051002,210670034051002,"Block 1002, Block Group 1, Census Tract 34.05, Fayette County, Kentucky",211,205,6
1000000US210670034051003,210670034051003,"Block 1003, Block Group 1, Census Tract 34.05, Fayette County, Kentucky",31,30,1
1000000US210670034051004,210670034051004,"Block 1004, Block Group 1, Census Tract 34.05, Fayette County, Kentucky",265,255,10
1000000US210670034051005,210670034051005,"Block 1005, Block Group 1, Census Tract 34.05, Fayette County, Kentucky",56,54,2
1000000US210670034051006,210670034051006,"Block 1006, Block Group 1, Census Tract 34.05, Fayette County, Kentucky",58,54,4
1000000US210670034051007,210670034051007,"Block 1007, Block Group 1, Census Tract 34.05, Fayette County, Kentucky",56,52,4
1000000US210670034051008,210670034051008,"Block 1008, Block Group 1, Census Tract 34.05, Fayette County, Kentucky",21,21,0
1000000US210670034051009,210670034051009,"Block 1009, Block Group 1, Census Tract 34.05, Fayette County, Kentucky",17,16,1
1000000US210670034051010,210670034051010,"Block 1010, Block Group 1, Census Tract 34.05, Fayette County, Kentucky",68,66,2
1000000US210670034051011,210670034051011,"Block 1011, Block Group 1, Census Tract 34.05, Fayette County, Kentucky",13,12,1
1000000US210670034051012,210670034051012,"Block 1012, Block Group 1, Census Tract 34.05, Fayette County, Kentucky",35,35,0
1000000US210670034051013,210670034051013,"Block 1013, Block Group 1, Census Tract 34.05, Fayette County, Kentucky",21,21,0
1000000US210670034051014,210670034051014,"Block 1014, Block Group 1, Census Tract 34.05, Fayette County, Kentucky",33,33,0
1000000US210670034051015,210670034051015,"Block 1015, Block Group 1, Census Tract 34.05, Fayette County, Kentucky",2,2,0
1000000US210670034051016,210670034051016,"Block 1016, Block Group 1, Census Tract 34.05, Fayette County, Kentucky",6,6,0
1000000US210670034051017,210670034051017,"Block 1017, Block Group 1, Census Tract 34.05, Fayette County, Kentucky",4,2,2
1000000US210670034052000,210670034052000,"Block 2000, Block Group 2, Census Tract 34.05, Fayette County, Kentucky",101,101,0
1000000US210670034052001,210670034052001,"Block 2001, Block Group 2, Census Tract 34.05, Fayette County, Kentucky",25,25,0
1000000US210670034052002,210670034052002,"Block 2002, Block Group 2, Census Tract 34.05, Fayette County, Kentucky",12,12,0
1000000US210670034052003,210670034052003,"Block 2003, Block Group 2, Census Tract 34.05, Fayette County, Kentucky",87,87,0
1000000US210670034052004,210670034052004,"Block 2004, Block Group 2, Census Tract 34.05, Fayette County, Kentucky",587,560,27
1000000US210670034052005,210670034052005,"Block 2005, Block Group 2, Census Tract 34.05, Fayette County, Kentucky",32,31,1
1000000US210670034052006,210670034052006,"Block 2006, Block Group 2, Census Tract 34.05, Fayette County, Kentucky",12,12,0
1000000US210670034052007,210670034052007,"Block 2007, Block Group 2, Census Tract 34.05, Fayette County, Kentucky",43,42,1
1000000US210670034052008,210670034052008,"Block 2008, Block Group 2, Census Tract 34.05, Fayette County, Kentucky",51,51,0
1000000US210670034052009,210670034052009,"Block 2009, Block Group 2, Census Tract 34.05, Fayette County, Kentucky",10,10,0
1000000US210670034053000,210670034053000,"Block 3000, Block Group 3, Census Tract 34.05, Fayette County, Kentucky",137,122,15
1000000US210670034053001,210670034053001,"Block 3001, Block Group 3, Census Tract 34.05, Fayette County, Kentucky",31,29,2
1000000US210670034053002,210670034053002,"Block 3002, Block Group 3, Census Tract 34.05, Fayette County, Kentucky",163,161,2
1000000US210670034053003,210670034053003,"Block 3003, Block Group 3, Census Tract 34.05, Fayette County, Kentucky",91,90,1
1000000US210670034053004,210670034053004,"Block 3004, Block Group 3, Census Tract 34.05, Fayette County, Kentucky",64,63,1
1000000US210670034053005,210670034053005,"Block 3005, Block Group 3, Census Tract 34.05, Fayette County, Kentucky",41,41,0
1000000US210670034061000,210670034061000,"Block 1000, Block Group 1, Census Tract 34.06, Fayette County, Kentucky",65,65,0
1000000US210670034061001,210670034061001,"Block 1001, Block Group 1, Census Tract 34.06, Fayette County, Kentucky",37,36,1
1000000US210670034061002,210670034061002,"Block 1002, Block Group 1, Census Tract 34.06, Fayette County, Kentucky",103,101,2
1000000US210670034061003,210670034061003,"Block 1003, Block Group 1, Census Tract 34.06, Fayette County, Kentucky",43,41,2
1000000US210670034061004,210670034061004,"Block 1004, Block Group 1, Census Tract 34.06, Fayette County, Kentucky",44,42,2
1000000US210670034061005,210670034061005,"Block 1005, Block Group 1, Census Tract 34.06, Fayette County, Kentucky",486,471,15
1000000US210670034061006,210670034061006,"Block 1006, Block Group 1, Census Tract 34.06, Fayette County, Kentucky",38,36,2
1000000US210670034061007,210670034061007,"Block 1007, Block Group 1, Census Tract 34.06, Fayette County, Kentucky",72,72,0
1000000US210670034061008,210670034061008,"Block 1008, Block Group 1, Census Tract 34.06, Fayette County, Kentucky",373,364,9
1000000US210670034061009,210670034061009,"Block 1009, Block Group 1, Census Tract 34.06, Fayette County, Kentucky",8,8,0
1000000US210670034061010,210670034061010,"Block 1010, Block Group 1, Census Tract 34.06, Fayette County, Kentucky",14,13,1
1000000US210670034061011,210670034061011,"Block 1011, Block Group 1, Census Tract 34.06, Fayette County, Kentucky",26,26,0
1000000US210670034061012,210670034061012,"Block 1012, Block Group 1, Census Tract 34.06, Fayette County, Kentucky",17,17,0
1000000US210670034061013,210670034061013,"Block 1013, Block Group 1, Census Tract 34.06, Fayette County, Kentucky",31,30,1
1000000US210670034061014,210670034061014,"Block 1014, Block Group 1, Census Tract 34.06, Fayette County, Kentucky",340,333,7
1000000US210670034061015,210670034061015,"Block 1015, Block Group 1, Census Tract 34.06, Fayette County, Kentucky",19,18,1
1000000US210670034061016,210670034061016,"Block 1016, Block Group 1, Census Tract 34.06, Fayette County, Kentucky",5,5,0
1000000US210670034061017,210670034061017,"Block 1017, Block Group 1, Census Tract 34.06, Fayette County, Kentucky",24,23,1
1000000US210670034061018,210670034061018,"Block 1018, Block Group 1, Census Tract 34.06, Fayette County, Kentucky",558,551,7
1000000US210670034061019,210670034061019,"Block 1019, Block Group 1, Census Tract 34.06, Fayette County, Kentucky",87,84,3
1000000US210670034061020,210670034061020,"Block 1020, Block Group 1, Census Tract 34.06, Fayette County, Kentucky",16,15,1
1000000US210670034061021,210670034061021,"Block 1021, Block Group 1, Census Tract 34.06, Fayette County, Kentucky",37,36,1
1000000US210670034061022,210670034061022,"Block 1022, Block Group 1, Census Tract 34.06, Fayette County, Kentucky",53,49,4
1000000US210670034061023,210670034061023,"Block 1023, Block Group 1, Census Tract 34.06, Fayette County, Kentucky",0,0,0
1000000US210670034061024,210670034061024,"Block 1024, Block Group 1, Census Tract 34.06, Fayette County, Kentucky",24,24,0
1000000US210670034061025,210670034061025,"Block 1025, Block Group 1, Census Tract 34.06, Fayette County, Kentucky",0,0,0
1000000US210670034061026,210670034061026,"Block 1026, Block Group 1, Census Tract 34.06, Fayette County, Kentucky",1,1,0
1000000US210670034061027,210670034061027,"Block 1027, Block Group 1, Census Tract 34.06, Fayette County, Kentucky",4,3,1
1000000US210670034061028,210670034061028,"Block 1028, Block Group 1, Census Tract 34.06, Fayette County, Kentucky",57,54,3
1000000US210670034061029,210670034061029,"Block 1029, Block Group 1, Census Tract 34.06, Fayette County, Kentucky",105,104,1
1000000US210670034061030,210670034061030,"Block 1030, Block Group 1, Census Tract 34.06, Fayette County, Kentucky",90,87,3
1000000US210670034061031,210670034061031,"Block 1031, Block Group 1, Census Tract 34.06, Fayette County, Kentucky",41,38,3
1000000US210670034061999,210670034061999,"Block 1999, Block Group 1, Census Tract 34.06, Fayette County, Kentucky",0,0,0
1000000US210670034071000,210670034071000,"Block 1000, Block Group 1, Census Tract 34.07, Fayette County, Kentucky",5,5,0
1000000US210670034071001,210670034071001,"Block 1001, Block Group 1, Census Tract 34.07, Fayette County, Kentucky",249,187,62
1000000US210670034071002,210670034071002,"Block 1002, Block Group 1, Census Tract 34.07, Fayette County, Kentucky",15,15,0
1000000US210670034071003,210670034071003,"Block 1003, Block Group 1, Census Tract 34.07, Fayette County, Kentucky",212,186,26
1000000US210670034071004,210670034071004,"Block 1004, Block Group 1, Census Tract 34.07, Fayette County, Kentucky",52,50,2
1000000US210670034071005,210670034071005,"Block 1005, Block Group 1, Census Tract 34.07, Fayette County, Kentucky",0,0,0
1000000US210670034071006,210670034071006,"Block 1006, Block Group 1, Census Tract 34.07, Fayette County, Kentucky",265,243,22
1000000US210670034071007,210670034071007,"Block 1007, Block Group 1, Census Tract 34.07, Fayette County, Kentucky",54,49,5
1000000US210670034071008,210670034071008,"Block 1008, Block Group 1, Census Tract 34.07, Fayette County, Kentucky",68,66,2
1000000US210670034071009,210670034071009,"Block 1009, Block Group 1, Census Tract 34.07, Fayette County, Kentucky",37,37,0
1000000US210670034071010,210670034071010,"Block 1010, Block Group 1, Census Tract 34.07, Fayette County, Kentucky",148,137,11
1000000US210670034071011,210670034071011,"Block 1011, Block Group 1, Census Tract 34.07, Fayette County, Kentucky",27,25,2
1000000US210670034071012,210670034071012,"Block 1012, Block Group 1, Census Tract 34.07, Fayette County, Kentucky",23,22,1
1000000US210670034071013,210670034071013,"Block 1013, Block Group 1, Census Tract 34.07, Fayette County, Kentucky",137,137,0
1000000US210670034071014,210670034071014,"Block 1014, Block Group 1, Census Tract 34.07, Fayette County, Kentucky",47,46,1
1000000US210670034071015,210670034071015,"Block 1015, Block Group 1, Census Tract 34.07, Fayette County, Kentucky",11,11,0
1000000US210670034071016,210670034071016,"Block 1016, Block Group 1, Census Tract 34.07, Fayette County, Kentucky",103,100,3
1000000US210670034071998,210670034071998,"Block 1998, Block Group 1, Census Tract 34.07, Fayette County, Kentucky",0,0,0
1000000US210670034071999,210670034071999,"Block 1999, Block Group 1, Census Tract 34.07, Fayette County, Kentucky",0,0,0
1000000US210670035011000,210670035011000,"Block 1000, Block Group 1, Census Tract 35.01, Fayette County, Kentucky",472,441,31
1000000US210670035011001,210670035011001,"Block 1001, Block Group 1, Census Tract 35.01, Fayette County, Kentucky",18,18,0
1000000US210670035011002,210670035011002,"Block 1002, Block Group 1, Census Tract 35.01, Fayette County, Kentucky",6,6,0
1000000US210670035011003,210670035011003,"Block 1003, Block Group 1, Census Tract 35.01, Fayette County, Kentucky",6,6,0
1000000US210670035011004,210670035011004,"Block 1004, Block Group 1, Census Tract 35.01, Fayette County, Kentucky",93,83,10
1000000US210670035011005,210670035011005,"Block 1005, Block Group 1, Census Tract 35.01, Fayette County, Kentucky",0,0,0
1000000US210670035011006,210670035011006,"Block 1006, Block Group 1, Census Tract 35.01, Fayette County, Kentucky",29,28,1
1000000US210670035011007,210670035011007,"Block 1007, Block Group 1, Census Tract 35.01, Fayette County, Kentucky",42,41,1
1000000US210670035011008,210670035011008,"Block 1008, Block Group 1, Census Tract 35.01, Fayette County, Kentucky",34,32,2
1000000US210670035011009,210670035011009,"Block 1009, Block Group 1, Census Tract 35.01, Fayette County, Kentucky",23,22,1
1000000US210670035011010,210670035011010,"Block 1010, Block Group 1, Census Tract 35.01, Fayette County, Kentucky",36,35,1
1000000US210670035011011,210670035011011,"Block 1011, Block Group 1, Census Tract 35.01, Fayette County, Kentucky",34,33,1
1000000US210670035011012,210670035011012,"Block 1012, Block Group 1, Census Tract 35.01, Fayette County, Kentucky",26,26,0
1000000US210670035011013,210670035011013,"Block 1013, Block Group 1, Census Tract 35.01, Fayette County, Kentucky",25,23,2
1000000US210670035011014,210670035011014,"Block 1014, Block Group 1, Census Tract 35.01, Fayette County, Kentucky",70,66,4
1000000US210670035011015,210670035011015,"Block 1015, Block Group 1, Census Tract 35.01, Fayette County, Kentucky",40,39,1
1000000US210670035011016,210670035011016,"Block 1016, Block Group 1, Census Tract 35.01, Fayette County, Kentucky",53,52,1
1000000US210670035011017,210670035011017,"Block 1017, Block Group 1, Census Tract 35.01, Fayette County, Kentucky",70,66,4
1000000US210670035011018,210670035011018,"Block 1018, Block Group 1, Census Tract 35.01, Fayette County, Kentucky",105,104,1
1000000US210670035011019,210670035011019,"Block 1019, Block Group 1, Census Tract 35.01, Fayette County, Kentucky",44,42,2
1000000US210670035011020,210670035011020,"Block 1020, Block Group 1, Census Tract 35.01, Fayette County, Kentucky",25,23,2
1000000US210670035011021,210670035011021,"Block 1021, Block Group 1, Census Tract 35.01, Fayette County, Kentucky",8,8,0
1000000US210670035011022,210670035011022,"Block 1022, Block Group 1, Census Tract 35.01, Fayette County, Kentucky",32,32,0
1000000US210670035011023,210670035011023,"Block 1023, Block Group 1, Census Tract 35.01, Fayette County, Kentucky",40,39,1
1000000US210670035011024,210670035011024,"Block 1024, Block Group 1, Census Tract 35.01, Fayette County, Kentucky",26,26,0
1000000US210670035011025,210670035011025,"Block 1025, Block Group 1, Census Tract 35.01, Fayette County, Kentucky",92,92,0
1000000US210670035021000,210670035021000,"Block 1000, Block Group 1, Census Tract 35.02, Fayette County, Kentucky",953,886,67
1000000US210670035021001,210670035021001,"Block 1001, Block Group 1, Census Tract 35.02, Fayette County, Kentucky",136,132,4
1000000US210670035021002,210670035021002,"Block 1002, Block Group 1, Census Tract 35.02, Fayette County, Kentucky",15,15,0
1000000US210670035021003,210670035021003,"Block 1003, Block Group 1, Census Tract 35.02, Fayette County, Kentucky",389,367,22
1000000US210670035021004,210670035021004,"Block 1004, Block Group 1, Census Tract 35.02, Fayette County, Kentucky",0,0,0
1000000US210670035021005,210670035021005,"Block 1005, Block Group 1, Census Tract 35.02, Fayette County, Kentucky",11,10,1
1000000US210670035021006,210670035021006,"Block 1006, Block Group 1, Census Tract 35.02, Fayette County, Kentucky",35,34,1
1000000US210670035021007,210670035021007,"Block 1007, Block Group 1, Census Tract 35.02, Fayette County, Kentucky",439,424,15
1000000US210670035021008,210670035021008,"Block 1008, Block Group 1, Census Tract 35.02, Fayette County, Kentucky",659,617,42
1000000US210670035021009,210670035021009,"Block 1009, Block Group 1, Census Tract 35.02, Fayette County, Kentucky",27,24,3
1000000US210670035021010,210670035021010,"Block 1010, Block Group 1, Census Tract 35.02, Fayette County, Kentucky",176,168,8
1000000US210670035021011,210670035021011,"Block 1011, Block Group 1, Census Tract 35.02, Fayette County, Kentucky",9,9,0
1000000US210670035021012,210670035021012,"Block 1012, Block Group 1, Census Tract 35.02, Fayette County, Kentucky",12,12,0
1000000US210670035021013,210670035021013,"Block 1013, Block Group 1, Census Tract 35.02, Fayette County, Kentucky",233,226,7
1000000US210670035021014,210670035021014,"Block 1014, Block Group 1, Census Tract 35.02, Fayette County, Kentucky",151,125,26
1000000US210670035021015,210670035021015,"Block 1015, Block Group 1, Census Tract 35.02, Fayette County, Kentucky",0,0,0
1000000US210670035021016,210670035021016,"Block 1016, Block Group 1, Census Tract 35.02, Fayette County, Kentucky",654,511,143
1000000US210670035021017,210670035021017,"Block 1017, Block Group 1, Census Tract 35.02, Fayette County, Kentucky",4,4,0
1000000US210670036001000,210670036001000,"Block 1000, Block Group 1, Census Tract 36, Fayette County, Kentucky",64,63,1
1000000US210670036001001,210670036001001,"Block 1001, Block Group 1, Census Tract 36, Fayette County, Kentucky",0,0,0
1000000US210670036001002,210670036001002,"Block 1002, Block Group 1, Census Tract 36, Fayette County, Kentucky",3,3,0
1000000US210670036001003,210670036001003,"Block 1003, Block Group 1, Census Tract 36, Fayette County, Kentucky",25,25,0
1000000US210670036001004,210670036001004,"Block 1004, Block Group 1, Census Tract 36, Fayette County, Kentucky",31,31,0
1000000US210670036001005,210670036001005,"Block 1005, Block Group 1, Census Tract 36, Fayette County, Kentucky",114,112,2
1000000US210670036001006,210670036001006,"Block 1006, Block Group 1, Census Tract 36, Fayette County, Kentucky",26,25,1
1000000US210670036001007,210670036001007,"Block 1007, Block Group 1, Census Tract 36, Fayette County, Kentucky",22,22,0
1000000US210670036001008,210670036001008,"Block 1008, Block Group 1, Census Tract 36, Fayette County, Kentucky",16,16,0
1000000US210670036001009,210670036001009,"Block 1009, Block Group 1, Census Tract 36, Fayette County, Kentucky",16,16,0
1000000US210670036001010,210670036001010,"Block 1010, Block Group 1, Census Tract 36, Fayette County, Kentucky",18,16,2
1000000US210670036001011,210670036001011,"Block 1011, Block Group 1, Census Tract 36, Fayette County, Kentucky",33,31,2
1000000US210670036001012,210670036001012,"Block 1012, Block Group 1, Census Tract 36, Fayette County, Kentucky",27,27,0
1000000US210670036001013,210670036001013,"Block 1013, Block Group 1, Census Tract 36, Fayette County, Kentucky",47,44,3
1000000US210670036001014,210670036001014,"Block 1014, Block Group 1, Census Tract 36, Fayette County, Kentucky",19,19,0
1000000US210670036002000,210670036002000,"Block 2000, Block Group 2, Census Tract 36, Fayette County, Kentucky",52,51,1
1000000US210670036002001,210670036002001,"Block 2001, Block Group 2, Census Tract 36, Fayette County, Kentucky",23,23,0
1000000US210670036002002,210670036002002,"Block 2002, Block Group 2, Census Tract 36, Fayette County, Kentucky",26,26,0
1000000US210670036002003,210670036002003,"Block 2003, Block Group 2, Census Tract 36, Fayette County, Kentucky",16,16,0
1000000US210670036002004,210670036002004,"Block 2004, Block Group 2, Census Tract 36, Fayette County, Kentucky",14,14,0
1000000US210670036002005,210670036002005,"Block 2005, Block Group 2, Census Tract 36, Fayette County, Kentucky",20,20,0
1000000US210670036002006,210670036002006,"Block 2006, Block Group 2, Census Tract 36, Fayette County, Kentucky",24,24,0
1000000US210670036002007,210670036002007,"Block 2007, Block Group 2, Census Tract 36, Fayette County, Kentucky",115,113,2
1000000US210670036002008,210670036002008,"Block 2008, Block Group 2, Census Tract 36, Fayette County, Kentucky",28,27,1
1000000US210670036002009,210670036002009,"Block 2009, Block Group 2, Census Tract 36, Fayette County, Kentucky",40,40,0
1000000US210670036002010,210670036002010,"Block 2010, Block Group 2, Census Tract 36, Fayette County, Kentucky",78,76,2
1000000US210670036002011,210670036002011,"Block 2011, Block Group 2, Census Tract 36, Fayette County, Kentucky",24,24,0
1000000US210670036002012,210670036002012,"Block 2012, Block Group 2, Census Tract 36, Fayette County, Kentucky",35,34,1
1000000US210670036002013,210670036002013,"Block 2013, Block Group 2, Census Tract 36, Fayette County, Kentucky",20,20,0
1000000US210670036002014,210670036002014,"Block 2014, Block Group 2, Census Tract 36, Fayette County, Kentucky",41,40,1
1000000US210670036002015,210670036002015,"Block 2015, Block Group 2, Census Tract 36, Fayette County, Kentucky",77,77,0
1000000US210670036002016,210670036002016,"Block 2016, Block Group 2, Census Tract 36, Fayette County, Kentucky",16,15,1
1000000US210670036002017,210670036002017,"Block 2017, Block Group 2, Census Tract 36, Fayette County, Kentucky",0,0,0
1000000US210670036003000,210670036003000,"Block 3000, Block Group 3, Census Tract 36, Fayette County, Kentucky",42,41,1
1000000US210670036003001,210670036003001,"Block 3001, Block Group 3, Census Tract 36, Fayette County, Kentucky",53,50,3
1000000US210670036003002,210670036003002,"Block 3002, Block Group 3, Census Tract 36, Fayette County, Kentucky",0,0,0
1000000US210670036003003,210670036003003,"Block 3003, Block Group 3, Census Tract 36, Fayette County, Kentucky",10,9,1
1000000US210670036003004,210670036003004,"Block 3004, Block Group 3, Census Tract 36, Fayette County, Kentucky",93,90,3
1000000US210670036003005,210670036003005,"Block 3005, Block Group 3, Census Tract 36, Fayette County, Kentucky",20,20,0
1000000US210670036003006,210670036003006,"Block 3006, Block Group 3, Census Tract 36, Fayette County, Kentucky",4,4,0
1000000US210670036003007,210670036003007,"Block 3007, Block Group 3, Census Tract 36, Fayette County, Kentucky",50,39,11
1000000US210670036003008,210670036003008,"Block 3008, Block Group 3, Census Tract 36, Fayette County, Kentucky",40,36,4
1000000US210670036003009,210670036003009,"Block 3009, Block Group 3, Census Tract 36, Fayette County, Kentucky",13,13,0
1000000US210670036003010,210670036003010,"Block 3010, Block Group 3, Census Tract 36, Fayette County, Kentucky",86,86,0
1000000US210670036003011,210670036003011,"Block 3011, Block Group 3, Census Tract 36, Fayette County, Kentucky",56,56,0
1000000US210670036003012,210670036003012,"Block 3012, Block Group 3, Census Tract 36, Fayette County, Kentucky",10,10,0
1000000US210670036003013,210670036003013,"Block 3013, Block Group 3, Census Tract 36, Fayette County, Kentucky",7,7,0
1000000US210670036003014,210670036003014,"Block 3014, Block Group 3, Census Tract 36, Fayette County, Kentucky",45,44,1
1000000US210670036003015,210670036003015,"Block 3015, Block Group 3, Census Tract 36, Fayette County, Kentucky",10,10,0
1000000US210670036003016,210670036003016,"Block 3016, Block Group 3, Census Tract 36, Fayette County, Kentucky",0,0,0
1000000US210670036003017,210670036003017,"Block 3017, Block Group 3, Census Tract 36, Fayette County, Kentucky",35,35,0
1000000US210670036003018,210670036003018,"Block 3018, Block Group 3, Census Tract 36, Fayette County, Kentucky",18,18,0
1000000US210670036003019,210670036003019,"Block 3019, Block Group 3, Census Tract 36, Fayette County, Kentucky",43,42,1
1000000US210670036003020,210670036003020,"Block 3020, Block Group 3, Census Tract 36, Fayette County, Kentucky",0,0,0
1000000US210670037001000,210670037001000,"Block 1000, Block Group 1, Census Tract 37, Fayette County, Kentucky",1,1,0
1000000US210670037001001,210670037001001,"Block 1001, Block Group 1, Census Tract 37, Fayette County, Kentucky",29,27,2
1000000US210670037001002,210670037001002,"Block 1002, Block Group 1, Census Tract 37, Fayette County, Kentucky",1,0,1
1000000US210670037001003,210670037001003,"Block 1003, Block Group 1, Census Tract 37, Fayette County, Kentucky",0,0,0
1000000US210670037001004,210670037001004,"Block 1004, Block Group 1, Census Tract 37, Fayette County, Kentucky",4,2,2
1000000US210670037001005,210670037001005,"Block 1005, Block Group 1, Census Tract 37, Fayette County, Kentucky",23,21,2
1000000US210670037001006,210670037001006,"Block 1006, Block Group 1, Census Tract 37, Fayette County, Kentucky",24,20,4
1000000US210670037001007,210670037001007,"Block 1007, Block Group 1, Census Tract 37, Fayette County, Kentucky",2,2,0
1000000US210670037001008,210670037001008,"Block 1008, Block Group 1, Census Tract 37, Fayette County, Kentucky",0,0,0
1000000US210670037001009,210670037001009,"Block 1009, Block Group 1, Census Tract 37, Fayette County, Kentucky",0,0,0
1000000US210670037001010,210670037001010,"Block 1010, Block Group 1, Census Tract 37, Fayette County, Kentucky",4,4,0
1000000US210670037001011,210670037001011,"Block 1011, Block Group 1, Census Tract 37, Fayette County, Kentucky",4,4,0
1000000US210670037001012,210670037001012,"Block 1012, Block Group 1, Census Tract 37, Fayette County, Kentucky",0,0,0
1000000US210670037001013,210670037001013,"Block 1013, Block Group 1, Census Tract 37, Fayette County, Kentucky",0,0,0
1000000US210670037001014,210670037001014,"Block 1014, Block Group 1, Census Tract 37, Fayette County, Kentucky",0,0,0
1000000US210670037001015,210670037001015,"Block 1015, Block Group 1, Census Tract 37, Fayette County, Kentucky",1,0,1
1000000US210670037001016,210670037001016,"Block 1016, Block Group 1, Census Tract 37, Fayette County, Kentucky",14,14,0
1000000US210670037001017,210670037001017,"Block 1017, Block Group 1, Census Tract 37, Fayette County, Kentucky",0,0,0
1000000US210670037001018,210670037001018,"Block 1018, Block Group 1, Census Tract 37, Fayette County, Kentucky",15,13,2
1000000US210670037001019,210670037001019,"Block 1019, Block Group 1, Census Tract 37, Fayette County, Kentucky",4,3,1
1000000US210670037001020,210670037001020,"Block 1020, Block Group 1, Census Tract 37, Fayette County, Kentucky",2,2,0
1000000US210670037001021,210670037001021,"Block 1021, Block Group 1, Census Tract 37, Fayette County, Kentucky",5,5,0
1000000US210670037001022,210670037001022,"Block 1022, Block Group 1, Census Tract 37, Fayette County, Kentucky",11,9,2
1000000US210670037001023,210670037001023,"Block 1023, Block Group 1, Census Tract 37, Fayette County, Kentucky",1,1,0
1000000US210670037001024,210670037001024,"Block 1024, Block Group 1, Census Tract 37, Fayette County, Kentucky",0,0,0
1000000US210670037001025,210670037001025,"Block 1025, Block Group 1, Census Tract 37, Fayette County, Kentucky",0,0,0
1000000US210670037001026,210670037001026,"Block 1026, Block Group 1, Census Tract 37, Fayette County, Kentucky",0,0,0
1000000US210670037001027,210670037001027,"Block 1027, Block Group 1, Census Tract 37, Fayette County, Kentucky",0,0,0
1000000US210670037001028,210670037001028,"Block 1028, Block Group 1, Census Tract 37, Fayette County, Kentucky",1,1,0
1000000US210670037002000,210670037002000,"Block 2000, Block Group 2, Census Tract 37, Fayette County, Kentucky",23,18,5
1000000US210670037002001,210670037002001,"Block 2001, Block Group 2, Census Tract 37, Fayette County, Kentucky",0,0,0
1000000US210670037002002,210670037002002,"Block 2002, Block Group 2, Census Tract 37, Fayette County, Kentucky",0,0,0
1000000US210670037002003,210670037002003,"Block 2003, Block Group 2, Census Tract 37, Fayette County, Kentucky",0,0,0
1000000US210670037002004,210670037002004,"Block 2004, Block Group 2, Census Tract 37, Fayette County, Kentucky",0,0,0
1000000US210670037002005,210670037002005,"Block 2005, Block Group 2, Census Tract 37, Fayette County, Kentucky",0,0,0
1000000US210670037002006,210670037002006,"Block 2006, Block Group 2, Census Tract 37, Fayette County, Kentucky",1,1,0
1000000US210670037002007,210670037002007,"Block 2007, Block Group 2, Census Tract 37, Fayette County, Kentucky",2,2,0
1000000US210670037002008,210670037002008,"Block 2008, Block Group 2, Census Tract 37, Fayette County, Kentucky",1,1,0
1000000US210670037002009,210670037002009,"Block 2009, Block Group 2, Census Tract 37, Fayette County, Kentucky",3,3,0
1000000US210670037002010,210670037002010,"Block 2010, Block Group 2, Census Tract 37, Fayette County, Kentucky",12,10,2
1000000US210670037002011,210670037002011,"Block 2011, Block Group 2, Census Tract 37, Fayette County, Kentucky",17,16,1
1000000US210670037002012,210670037002012,"Block 2012, Block Group 2, Census Tract 37, Fayette County, Kentucky",3,3,0
1000000US210670037002013,210670037002013,"Block 2013, Block Group 2, Census Tract 37, Fayette County, Kentucky",0,0,0
1000000US210670037002014,210670037002014,"Block 2014, Block Group 2, Census Tract 37, Fayette County, Kentucky",17,16,1
1000000US210670037002015,210670037002015,"Block 2015, Block Group 2, Census Tract 37, Fayette County, Kentucky",5,5,0
1000000US210670037002016,210670037002016,"Block 2016, Block Group 2, Census Tract 37, Fayette County, Kentucky",2,1,1
1000000US210670037002017,210670037002017,"Block 2017, Block Group 2, Census Tract 37, Fayette County, Kentucky",3,3,0
1000000US210670037002018,210670037002018,"Block 2018, Block Group 2, Census Tract 37, Fayette County, Kentucky",22,20,2
1000000US210670037002019,210670037002019,"Block 2019, Block Group 2, Census Tract 37, Fayette County, Kentucky",13,12,1
1000000US210670037002020,210670037002020,"Block 2020, Block Group 2, Census Tract 37, Fayette County, Kentucky",11,11,0
1000000US210670037002021,210670037002021,"Block 2021, Block Group 2, Census Tract 37, Fayette County, Kentucky",1,1,0
1000000US210670037002022,210670037002022,"Block 2022, Block Group 2, Census Tract 37, Fayette County, Kentucky",12,12,0
1000000US210670037002023,210670037002023,"Block 2023, Block Group 2, Census Tract 37, Fayette County, Kentucky",5,5,0
1000000US210670037002024,210670037002024,"Block 2024, Block Group 2, Census Tract 37, Fayette County, Kentucky",4,4,0
1000000US210670037002025,210670037002025,"Block 2025, Block Group 2, Census Tract 37, Fayette County, Kentucky",6,6,0
1000000US210670037002026,210670037002026,"Block 2026, Block Group 2, Census Tract 37, Fayette County, Kentucky",11,10,1
1000000US210670037002027,210670037002027,"Block 2027, Block Group 2, Census Tract 37, Fayette County, Kentucky",8,8,0
1000000US210670037002028,210670037002028,"Block 2028, Block Group 2, Census Tract 37, Fayette County, Kentucky",22,19,3
1000000US210670037002029,210670037002029,"Block 2029, Block Group 2, Census Tract 37, Fayette County, Kentucky",3,2,1
1000000US210670037002030,210670037002030,"Block 2030, Block Group 2, Census Tract 37, Fayette County, Kentucky",4,2,2
1000000US210670037002031,210670037002031,"Block 2031, Block Group 2, Census Tract 37, Fayette County, Kentucky",3,3,0
1000000US210670037002032,210670037002032,"Block 2032, Block Group 2, Census Tract 37, Fayette County, Kentucky",0,0,0
1000000US210670037002033,210670037002033,"Block 2033, Block Group 2, Census Tract 37, Fayette County, Kentucky",7,7,0
1000000US210670037002034,210670037002034,"Block 2034, Block Group 2, Census Tract 37, Fayette County, Kentucky",1,1,0
1000000US210670037002035,210670037002035,"Block 2035, Block Group 2, Census Tract 37, Fayette County, Kentucky",3,2,1
1000000US210670037002036,210670037002036,"Block 2036, Block Group 2, Census Tract 37, Fayette County, Kentucky",0,0,0
1000000US210670037002037,210670037002037,"Block 2037, Block Group 2, Census Tract 37, Fayette County, Kentucky",2,2,0
1000000US210670037002038,210670037002038,"Block 2038, Block Group 2, Census Tract 37, Fayette County, Kentucky",0,0,0
1000000US210670037002039,210670037002039,"Block 2039, Block Group 2, Census Tract 37, Fayette County, Kentucky",1,1,0
1000000US210670037002040,210670037002040,"Block 2040, Block Group 2, Census Tract 37, Fayette County, Kentucky",0,0,0
1000000US210670037002041,210670037002041,"Block 2041, Block Group 2, Census Tract 37, Fayette County, Kentucky",0,0,0
1000000US210670037002042,210670037002042,"Block 2042, Block Group 2, Census Tract 37, Fayette County, Kentucky",13,13,0
1000000US210670037002043,210670037002043,"Block 2043, Block Group 2, Census Tract 37, Fayette County, Kentucky",2,2,0
1000000US210670037002044,210670037002044,"Block 2044, Block Group 2, Census Tract 37, Fayette County, Kentucky",23,22,1
1000000US210670037002045,210670037002045,"Block 2045, Block Group 2, Census Tract 37, Fayette County, Kentucky",11,10,1
1000000US210670037002046,210670037002046,"Block 2046, Block Group 2, Census Tract 37, Fayette County, Kentucky",0,0,0
1000000US210670037002047,210670037002047,"Block 2047, Block Group 2, Census Tract 37, Fayette County, Kentucky",17,17,0
1000000US210670037002048,210670037002048,"Block 2048, Block Group 2, Census Tract 37, Fayette County, Kentucky",80,78,2
1000000US210670037002049,210670037002049,"Block 2049, Block Group 2, Census Tract 37, Fayette County, Kentucky",13,12,1
1000000US210670037002050,210670037002050,"Block 2050, Block Group 2, Census Tract 37, Fayette County, Kentucky",15,14,1
1000000US210670037002051,210670037002051,"Block 2051, Block Group 2, Census Tract 37, Fayette County, Kentucky",7,7,0
1000000US210670037002052,210670037002052,"Block 2052, Block Group 2, Census Tract 37, Fayette County, Kentucky",12,12,0
1000000US210670037003000,210670037003000,"Block 3000, Block Group 3, Census Tract 37, Fayette County, Kentucky",0,0,0
1000000US210670037003001,210670037003001,"Block 3001, Block Group 3, Census Tract 37, Fayette County, Kentucky",2,2,0
1000000US210670037003002,210670037003002,"Block 3002, Block Group 3, Census Tract 37, Fayette County, Kentucky",1,1,0
1000000US210670037003003,210670037003003,"Block 3003, Block Group 3, Census Tract 37, Fayette County, Kentucky",197,187,10
1000000US210670037003004,210670037003004,"Block 3004, Block Group 3, Census Tract 37, Fayette County, Kentucky",7,7,0
1000000US210670037003005,210670037003005,"Block 3005, Block Group 3, Census Tract 37, Fayette County, Kentucky",12,10,2
1000000US210670037003006,210670037003006,"Block 3006, Block Group 3, Census Tract 37, Fayette County, Kentucky",7,7,0
1000000US210670037003007,210670037003007,"Block 3007, Block Group 3, Census Tract 37, Fayette County, Kentucky",0,0,0
1000000US210670037003008,210670037003008,"Block 3008, Block Group 3, Census Tract 37, Fayette County, Kentucky",5,4,1
1000000US210670037003009,210670037003009,"Block 3009, Block Group 3, Census Tract 37, Fayette County, Kentucky",37,37,0
1000000US210670037003010,210670037003010,"Block 3010, Block Group 3, Census Tract 37, Fayette County, Kentucky",25,25,0
1000000US210670037003011,210670037003011,"Block 3011, Block Group 3, Census Tract 37, Fayette County, Kentucky",12,12,0
1000000US210670037003012,210670037003012,"Block 3012, Block Group 3, Census Tract 37, Fayette County, Kentucky",11,11,0
1000000US210670037003013,210670037003013,"Block 3013, Block Group 3, Census Tract 37, Fayette County, Kentucky",9,9,0
1000000US210670037003014,210670037003014,"Block 3014, Block Group 3, Census Tract 37, Fayette County, Kentucky",7,7,0
1000000US210670037003015,210670037003015,"Block 3015, Block Group 3, Census Tract 37, Fayette County, Kentucky",20,20,0
1000000US210670037003016,210670037003016,"Block 3016, Block Group 3, Census Tract 37, Fayette County, Kentucky",17,14,3
1000000US210670037003017,210670037003017,"Block 3017, Block Group 3, Census Tract 37, Fayette County, Kentucky",4,3,1
1000000US210670037003018,210670037003018,"Block 3018, Block Group 3, Census Tract 37, Fayette County, Kentucky",1,1,0
1000000US210670037003019,210670037003019,"Block 3019, Block Group 3, Census Tract 37, Fayette County, Kentucky",2,2,0
1000000US210670037003020,210670037003020,"Block 3020, Block Group 3, Census Tract 37, Fayette County, Kentucky",27,27,0
1000000US210670037003021,210670037003021,"Block 3021, Block Group 3, Census Tract 37, Fayette County, Kentucky",22,22,0
1000000US210670037003022,210670037003022,"Block 3022, Block Group 3, Census Tract 37, Fayette County, Kentucky",94,81,13
1000000US210670037003023,210670037003023,"Block 3023, Block Group 3, Census Tract 37, Fayette County, Kentucky",2,2,0
1000000US210670037003024,210670037003024,"Block 3024, Block Group 3, Census Tract 37, Fayette County, Kentucky",10,10,0
1000000US210670037003025,210670037003025,"Block 3025, Block Group 3, Census Tract 37, Fayette County, Kentucky",10,10,0
1000000US210670037003026,210670037003026,"Block 3026, Block Group 3, Census Tract 37, Fayette County, Kentucky",9,9,0
1000000US210670037003027,210670037003027,"Block 3027, Block Group 3, Census Tract 37, Fayette County, Kentucky",10,10,0
1000000US210670037003028,210670037003028,"Block 3028, Block Group 3, Census Tract 37, Fayette County, Kentucky",15,15,0
1000000US210670037003029,210670037003029,"Block 3029, Block Group 3, Census Tract 37, Fayette County, Kentucky",37,35,2
1000000US210670037003030,210670037003030,"Block 3030, Block Group 3, Census Tract 37, Fayette County, Kentucky",32,32,0
1000000US210670037003031,210670037003031,"Block 3031, Block Group 3, Census Tract 37, Fayette County, Kentucky",0,0,0
1000000US210670037003032,210670037003032,"Block 3032, Block Group 3, Census Tract 37, Fayette County, Kentucky",1,1,0
1000000US210670037003033,210670037003033,"Block 3033, Block Group 3, Census Tract 37, Fayette County, Kentucky",1,0,1
1000000US210670037003034,210670037003034,"Block 3034, Block Group 3, Census Tract 37, Fayette County, Kentucky",12,7,5
1000000US210670037003035,210670037003035,"Block 3035, Block Group 3, Census Tract 37, Fayette County, Kentucky",5,4,1
1000000US210670037003036,210670037003036,"Block 3036, Block Group 3, Census Tract 37, Fayette County, Kentucky",0,0,0
1000000US210670037003037,210670037003037,"Block 3037, Block Group 3, Census Tract 37, Fayette County, Kentucky",0,0,0
1000000US210670037003038,210670037003038,"Block 3038, Block Group 3, Census Tract 37, Fayette County, Kentucky",1,1,0
1000000US210670037003039,210670037003039,"Block 3039, Block Group 3, Census Tract 37, Fayette County, Kentucky",0,0,0
1000000US210670037003040,210670037003040,"Block 3040, Block Group 3, Census Tract 37, Fayette County, Kentucky",0,0,0
1000000US210670037003041,210670037003041,"Block 3041, Block Group 3, Census Tract 37, Fayette County, Kentucky",0,0,0
1000000US210670037003042,210670037003042,"Block 3042, Block Group 3, Census Tract 37, Fayette County, Kentucky",2,2,0
1000000US210670037003043,210670037003043,"Block 3043, Block Group 3, Census Tract 37, Fayette County, Kentucky",0,0,0
1000000US210670037003044,210670037003044,"Block 3044, Block Group 3, Census Tract 37, Fayette County, Kentucky",2,2,0
1000000US210670037003045,210670037003045,"Block 3045, Block Group 3, Census Tract 37, Fayette County, Kentucky",1,1,0
1000000US210670037003046,210670037003046,"Block 3046, Block Group 3, Census Tract 37, Fayette County, Kentucky",2,2,0
1000000US210670037003047,210670037003047,"Block 3047, Block Group 3, Census Tract 37, Fayette County, Kentucky",1,0,1
1000000US210670037003048,210670037003048,"Block 3048, Block Group 3, Census Tract 37, Fayette County, Kentucky",1,1,0
1000000US210670037003049,210670037003049,"Block 3049, Block Group 3, Census Tract 37, Fayette County, Kentucky",4,3,1
1000000US210670037003050,210670037003050,"Block 3050, Block Group 3, Census Tract 37, Fayette County, Kentucky",0,0,0
1000000US210670037003051,210670037003051,"Block 3051, Block Group 3, Census Tract 37, Fayette County, Kentucky",0,0,0
1000000US210670037003052,210670037003052,"Block 3052, Block Group 3, Census Tract 37, Fayette County, Kentucky",0,0,0
1000000US210670037003053,210670037003053,"Block 3053, Block Group 3, Census Tract 37, Fayette County, Kentucky",0,0,0
1000000US210670037003054,210670037003054,"Block 3054, Block Group 3, Census Tract 37, Fayette County, Kentucky",0,0,0
1000000US210670037003055,210670037003055,"Block 3055, Block Group 3, Census Tract 37, Fayette County, Kentucky",1,1,0
1000000US210670037003056,210670037003056,"Block 3056, Block Group 3, Census Tract 37, Fayette County, Kentucky",0,0,0
1000000US210670037003057,210670037003057,"Block 3057, Block Group 3, Census Tract 37, Fayette County, Kentucky",4,3,1
1000000US210670037003058,210670037003058,"Block 3058, Block Group 3, Census Tract 37, Fayette County, Kentucky",4,4,0
1000000US210670037003059,210670037003059,"Block 3059, Block Group 3, Census Tract 37, Fayette County, Kentucky",0,0,0
1000000US210670037003060,210670037003060,"Block 3060, Block Group 3, Census Tract 37, Fayette County, Kentucky",0,0,0
1000000US210670038011000,210670038011000,"Block 1000, Block Group 1, Census Tract 38.01, Fayette County, Kentucky",299,273,26
1000000US210670038011001,210670038011001,"Block 1001, Block Group 1, Census Tract 38.01, Fayette County, Kentucky",9,8,1
1000000US210670038011002,210670038011002,"Block 1002, Block Group 1, Census Tract 38.01, Fayette County, Kentucky",14,14,0
1000000US210670038011003,210670038011003,"Block 1003, Block Group 1, Census Tract 38.01, Fayette County, Kentucky",13,13,0
1000000US210670038011004,210670038011004,"Block 1004, Block Group 1, Census Tract 38.01, Fayette County, Kentucky",1723,1519,204
1000000US210670038011005,210670038011005,"Block 1005, Block Group 1, Census Tract 38.01, Fayette County, Kentucky",19,17,2
1000000US210670038011006,210670038011006,"Block 1006, Block Group 1, Census Tract 38.01, Fayette County, Kentucky",36,35,1
1000000US210670038011007,210670038011007,"Block 1007, Block Group 1, Census Tract 38.01, Fayette County, Kentucky",11,9,2
1000000US210670038011008,210670038011008,"Block 1008, Block Group 1, Census Tract 38.01, Fayette County, Kentucky",23,22,1
1000000US210670038011009,210670038011009,"Block 1009, Block Group 1, Census Tract 38.01, Fayette County, Kentucky",63,62,1
1000000US210670038011010,210670038011010,"Block 1010, Block Group 1, Census Tract 38.01, Fayette County, Kentucky",0,0,0
1000000US210670038011011,210670038011011,"Block 1011, Block Group 1, Census Tract 38.01, Fayette County, Kentucky",2,1,1
1000000US210670038011012,210670038011012,"Block 1012, Block Group 1, Census Tract 38.01, Fayette County, Kentucky",8,6,2
1000000US210670038011013,210670038011013,"Block 1013, Block Group 1, Census Tract 38.01, Fayette County, Kentucky",0,0,0
1000000US210670038011014,210670038011014,"Block 1014, Block Group 1, Census Tract 38.01, Fayette County, Kentucky",0,0,0
1000000US210670038011015,210670038011015,"Block 1015, Block Group 1, Census Tract 38.01, Fayette County, Kentucky",0,0,0
1000000US210670038011016,210670038011016,"Block 1016, Block Group 1, Census Tract 38.01, Fayette County, Kentucky",31,28,3
1000000US210670038011017,210670038011017,"Block 1017, Block Group 1, Census Tract 38.01, Fayette County, Kentucky",0,0,0
1000000US210670038011018,210670038011018,"Block 1018, Block Group 1, Census Tract 38.01, Fayette County, Kentucky",10,10,0
1000000US210670038011019,210670038011019,"Block 1019, Block Group 1, Census Tract 38.01, Fayette County, Kentucky",20,20,0
1000000US210670038011020,210670038011020,"Block 1020, Block Group 1, Census Tract 38.01, Fayette County, Kentucky",22,21,1
1000000US210670038011021,210670038011021,"Block 1021, Block Group 1, Census Tract 38.01, Fayette County, Kentucky",170,168,2
1000000US210670038011022,210670038011022,"Block 1022, Block Group 1, Census Tract 38.01, Fayette County, Kentucky",5,5,0
1000000US210670038011023,210670038011023,"Block 1023, Block Group 1, Census Tract 38.01, Fayette County, Kentucky",21,20,1
1000000US210670038011024,210670038011024,"Block 1024, Block Group 1, Census Tract 38.01, Fayette County, Kentucky",18,16,2
1000000US210670038011025,210670038011025,"Block 1025, Block Group 1, Census Tract 38.01, Fayette County, Kentucky",22,21,1
1000000US210670038011026,210670038011026,"Block 1026, Block Group 1, Census Tract 38.01, Fayette County, Kentucky",0,0,0
1000000US210670038011027,210670038011027,"Block 1027, Block Group 1, Census Tract 38.01, Fayette County, Kentucky",0,0,0
1000000US210670038011999,210670038011999,"Block 1999, Block Group 1, Census Tract 38.01, Fayette County, Kentucky",0,0,0
1000000US210670038012000,210670038012000,"Block 2000, Block Group 2, Census Tract 38.01, Fayette County, Kentucky",1,1,0
1000000US210670038012001,210670038012001,"Block 2001, Block Group 2, Census Tract 38.01, Fayette County, Kentucky",3,3,0
1000000US210670038012002,210670038012002,"Block 2002, Block Group 2, Census Tract 38.01, Fayette County, Kentucky",2,2,0
1000000US210670038012003,210670038012003,"Block 2003, Block Group 2, Census Tract 38.01, Fayette County, Kentucky",23,23,0
1000000US210670038012004,210670038012004,"Block 2004, Block Group 2, Census Tract 38.01, Fayette County, Kentucky",256,248,8
1000000US210670038012005,210670038012005,"Block 2005, Block Group 2, Census Tract 38.01, Fayette County, Kentucky",0,0,0
1000000US210670038012006,210670038012006,"Block 2006, Block Group 2, Census Tract 38.01, Fayette County, Kentucky",42,41,1
1000000US210670038012007,210670038012007,"Block 2007, Block Group 2, Census Tract 38.01, Fayette County, Kentucky",14,13,1
1000000US210670038012008,210670038012008,"Block 2008, Block Group 2, Census Tract 38.01, Fayette County, Kentucky",24,23,1
1000000US210670038012009,210670038012009,"Block 2009, Block Group 2, Census Tract 38.01, Fayette County, Kentucky",19,18,1
1000000US210670038012010,210670038012010,"Block 2010, Block Group 2, Census Tract 38.01, Fayette County, Kentucky",29,29,0
1000000US210670038012011,210670038012011,"Block 2011, Block Group 2, Census Tract 38.01, Fayette County, Kentucky",58,58,0
1000000US210670038012012,210670038012012,"Block 2012, Block Group 2, Census Tract 38.01, Fayette County, Kentucky",45,45,0
1000000US210670038012013,210670038012013,"Block 2013, Block Group 2, Census Tract 38.01, Fayette County, Kentucky",0,0,0
1000000US210670038012014,210670038012014,"Block 2014, Block Group 2, Census Tract 38.01, Fayette County, Kentucky",0,0,0
1000000US210670038012015,210670038012015,"Block 2015, Block Group 2, Census Tract 38.01, Fayette County, Kentucky",2,2,0
1000000US210670038012016,210670038012016,"Block 2016, Block Group 2, Census Tract 38.01, Fayette County, Kentucky",5,5,0
1000000US210670038012017,210670038012017,"Block 2017, Block Group 2, Census Tract 38.01, Fayette County, Kentucky",0,0,0
1000000US210670038012018,210670038012018,"Block 2018, Block Group 2, Census Tract 38.01, Fayette County, Kentucky",0,0,0
1000000US210670038012019,210670038012019,"Block 2019, Block Group 2, Census Tract 38.01, Fayette County, Kentucky",0,0,0
1000000US210670038012020,210670038012020,"Block 2020, Block Group 2, Census Tract 38.01, Fayette County, Kentucky",0,0,0
1000000US210670038012999,210670038012999,"Block 2999, Block Group 2, Census Tract 38.01, Fayette County, Kentucky",0,0,0
1000000US210670038021000,210670038021000,"Block 1000, Block Group 1, Census Tract 38.02, Fayette County, Kentucky",6,5,1
1000000US210670038021001,210670038021001,"Block 1001, Block Group 1, Census Tract 38.02, Fayette County, Kentucky",0,0,0
1000000US210670038021002,210670038021002,"Block 1002, Block Group 1, Census Tract 38.02, Fayette County, Kentucky",15,15,0
1000000US210670038021003,210670038021003,"Block 1003, Block Group 1, Census Tract 38.02, Fayette County, Kentucky",29,27,2
1000000US210670038021004,210670038021004,"Block 1004, Block Group 1, Census Tract 38.02, Fayette County, Kentucky",13,13,0
1000000US210670038021005,210670038021005,"Block 1005, Block Group 1, Census Tract 38.02, Fayette County, Kentucky",1,1,0
1000000US210670038021006,210670038021006,"Block 1006, Block Group 1, Census Tract 38.02, Fayette County, Kentucky",24,21,3
1000000US210670038021007,210670038021007,"Block 1007, Block Group 1, Census Tract 38.02, Fayette County, Kentucky",33,32,1
1000000US210670038021008,210670038021008,"Block 1008, Block Group 1, Census Tract 38.02, Fayette County, Kentucky",18,17,1
1000000US210670038021009,210670038021009,"Block 1009, Block Group 1, Census Tract 38.02, Fayette County, Kentucky",3,3,0
1000000US210670038021010,210670038021010,"Block 1010, Block Group 1, Census Tract 38.02, Fayette County, Kentucky",32,30,2
1000000US210670038021011,210670038021011,"Block 1011, Block Group 1, Census Tract 38.02, Fayette County, Kentucky",8,8,0
1000000US210670038021012,210670038021012,"Block 1012, Block Group 1, Census Tract 38.02, Fayette County, Kentucky",2,2,0
1000000US210670038021013,210670038021013,"Block 1013, Block Group 1, Census Tract 38.02, Fayette County, Kentucky",2,2,0
1000000US210670038021014,210670038021014,"Block 1014, Block Group 1, Census Tract 38.02, Fayette County, Kentucky",17,16,1
1000000US210670038021015,210670038021015,"Block 1015, Block Group 1, Census Tract 38.02, Fayette County, Kentucky",29,27,2
1000000US210670038022000,210670038022000,"Block 2000, Block Group 2, Census Tract 38.02, Fayette County, Kentucky",40,38,2
1000000US210670038022001,210670038022001,"Block 2001, Block Group 2, Census Tract 38.02, Fayette County, Kentucky",1,0,1
1000000US210670038022002,210670038022002,"Block 2002, Block Group 2, Census Tract 38.02, Fayette County, Kentucky",5,5,0
1000000US210670038022003,210670038022003,"Block 2003, Block Group 2, Census Tract 38.02, Fayette County, Kentucky",14,13,1
1000000US210670038022004,210670038022004,"Block 2004, Block Group 2, Census Tract 38.02, Fayette County, Kentucky",10,4,6
1000000US210670038022005,210670038022005,"Block 2005, Block Group 2, Census Tract 38.02, Fayette County, Kentucky",20,20,0
1000000US210670038023000,210670038023000,"Block 3000, Block Group 3, Census Tract 38.02, Fayette County, Kentucky",10,7,3
1000000US210670038023001,210670038023001,"Block 3001, Block Group 3, Census Tract 38.02, Fayette County, Kentucky",18,16,2
1000000US210670038023002,210670038023002,"Block 3002, Block Group 3, Census Tract 38.02, Fayette County, Kentucky",25,25,0
1000000US210670038023003,210670038023003,"Block 3003, Block Group 3, Census Tract 38.02, Fayette County, Kentucky",36,31,5
1000000US210670038023004,210670038023004,"Block 3004, Block Group 3, Census Tract 38.02, Fayette County, Kentucky",33,31,2
1000000US210670038023005,210670038023005,"Block 3005, Block Group 3, Census Tract 38.02, Fayette County, Kentucky",0,0,0
1000000US210670038023006,210670038023006,"Block 3006, Block Group 3, Census Tract 38.02, Fayette County, Kentucky",0,0,0
1000000US210670038023007,210670038023007,"Block 3007, Block Group 3, Census Tract 38.02, Fayette County, Kentucky",9,9,0
1000000US210670038023008,210670038023008,"Block 3008, Block Group 3, Census Tract 38.02, Fayette County, Kentucky",0,0,0
1000000US210670038023009,210670038023009,"Block 3009, Block Group 3, Census Tract 38.02, Fayette County, Kentucky",9,9,0
1000000US210670038023010,210670038023010,"Block 3010, Block Group 3, Census Tract 38.02, Fayette County, Kentucky",4,4,0
1000000US210670038023011,210670038023011,"Block 3011, Block Group 3, Census Tract 38.02, Fayette County, Kentucky",4,4,0
1000000US210670038023012,210670038023012,"Block 3012, Block Group 3, Census Tract 38.02, Fayette County, Kentucky",10,10,0
1000000US210670038023013,210670038023013,"Block 3013, Block Group 3, Census Tract 38.02, Fayette County, Kentucky",21,21,0
1000000US210670038023014,210670038023014,"Block 3014, Block Group 3, Census Tract 38.02, Fayette County, Kentucky",9,8,1
1000000US210670038023015,210670038023015,"Block 3015, Block Group 3, Census Tract 38.02, Fayette County, Kentucky",3,3,0
1000000US210670038023016,210670038023016,"Block 3016, Block Group 3, Census Tract 38.02, Fayette County, Kentucky",6,5,1
1000000US210670038023017,210670038023017,"Block 3017, Block Group 3, Census Tract 38.02, Fayette County, Kentucky",54,49,5
1000000US210670038023018,210670038023018,"Block 3018, Block Group 3, Census Tract 38.02, Fayette County, Kentucky",23,18,5
1000000US210670038024000,210670038024000,"Block 4000, Block Group 4, Census Tract 38.02, Fayette County, Kentucky",43,37,6
1000000US210670038024001,210670038024001,"Block 4001, Block Group 4, Census Tract 38.02, Fayette County, Kentucky",3,3,0
1000000US210670038024002,210670038024002,"Block 4002, Block Group 4, Census Tract 38.02, Fayette County, Kentucky",0,0,0
1000000US210670038024003,210670038024003,"Block 4003, Block Group 4, Census Tract 38.02, Fayette County, Kentucky",1,1,0
1000000US210670038024004,210670038024004,"Block 4004, Block Group 4, Census Tract 38.02, Fayette County, Kentucky",68,66,2
1000000US210670038024005,210670038024005,"Block 4005, Block Group 4, Census Tract 38.02, Fayette County, Kentucky",1,1,0
1000000US210670038024006,210670038024006,"Block 4006, Block Group 4, Census Tract 38.02, Fayette County, Kentucky",0,0,0
1000000US210670038024007,210670038024007,"Block 4007, Block Group 4, Census Tract 38.02, Fayette County, Kentucky",14,14,0
1000000US210670038024008,210670038024008,"Block 4008, Block Group 4, Census Tract 38.02, Fayette County, Kentucky",119,116,3
1000000US210670038024009,210670038024009,"Block 4009, Block Group 4, Census Tract 38.02, Fayette County, Kentucky",0,0,0
1000000US210670038024010,210670038024010,"Block 4010, Block Group 4, Census Tract 38.02, Fayette County, Kentucky",0,0,0
1000000US210670038024011,210670038024011,"Block 4011, Block Group 4, Census Tract 38.02, Fayette County, Kentucky",1,1,0
1000000US210670038024012,210670038024012,"Block 4012, Block Group 4, Census Tract 38.02, Fayette County, Kentucky",10,8,2
1000000US210670038024013,210670038024013,"Block 4013, Block Group 4, Census Tract 38.02, Fayette County, Kentucky",8,7,1
1000000US210670038025000,210670038025000,"Block 5000, Block Group 5, Census Tract 38.02, Fayette County, Kentucky",102,92,10
1000000US210670038025001,210670038025001,"Block 5001, Block Group 5, Census Tract 38.02, Fayette County, Kentucky",26,22,4
1000000US210670039011000,210670039011000,"Block 1000, Block Group 1, Census Tract 39.01, Fayette County, Kentucky",259,253,6
1000000US210670039011001,210670039011001,"Block 1001, Block Group 1, Census Tract 39.01, Fayette County, Kentucky",0,0,0
1000000US210670039011002,210670039011002,"Block 1002, Block Group 1, Census Tract 39.01, Fayette County, Kentucky",135,131,4
1000000US210670039011003,210670039011003,"Block 1003, Block Group 1, Census Tract 39.01, Fayette County, Kentucky",728,680,48
1000000US210670039011004,210670039011004,"Block 1004, Block Group 1, Census Tract 39.01, Fayette County, Kentucky",25,23,2
1000000US210670039011005,210670039011005,"Block 1005, Block Group 1, Census Tract 39.01, Fayette County, Kentucky",27,27,0
1000000US210670039011006,210670039011006,"Block 1006, Block Group 1, Census Tract 39.01, Fayette County, Kentucky",108,107,1
1000000US210670039011007,210670039011007,"Block 1007, Block Group 1, Census Tract 39.01, Fayette County, Kentucky",70,67,3
1000000US210670039011008,210670039011008,"Block 1008, Block Group 1, Census Tract 39.01, Fayette County, Kentucky",455,290,165
1000000US210670039011009,210670039011009,"Block 1009, Block Group 1, Census Tract 39.01, Fayette County, Kentucky",0,0,0
1000000US210670039012000,210670039012000,"Block 2000, Block Group 2, Census Tract 39.01, Fayette County, Kentucky",1067,927,140
1000000US210670039012001,210670039012001,"Block 2001, Block Group 2, Census Tract 39.01, Fayette County, Kentucky",16,16,0
1000000US210670039012002,210670039012002,"Block 2002, Block Group 2, Census Tract 39.01, Fayette County, Kentucky",23,21,2
1000000US210670039012003,210670039012003,"Block 2003, Block Group 2, Census Tract 39.01, Fayette County, Kentucky",134,79,55
1000000US210670039012004,210670039012004,"Block 2004, Block Group 2, Census Tract 39.01, Fayette County, Kentucky",0,0,0
1000000US210670039012005,210670039012005,"Block 2005, Block Group 2, Census Tract 39.01, Fayette County, Kentucky",0,0,0
1000000US210670039012006,210670039012006,"Block 2006, Block Group 2, Census Tract 39.01, Fayette County, Kentucky",0,0,0
1000000US210670039012007,210670039012007,"Block 2007, Block Group 2, Census Tract 39.01, Fayette County, Kentucky",0,0,0
1000000US210670039012008,210670039012008,"Block 2008, Block Group 2, Census Tract 39.01, Fayette County, Kentucky",0,0,0
1000000US210670039041000,210670039041000,"Block 1000, Block Group 1, Census Tract 39.04, Fayette County, Kentucky",4,4,0
1000000US210670039041001,210670039041001,"Block 1001, Block Group 1, Census Tract 39.04, Fayette County, Kentucky",3,3,0
1000000US210670039041002,210670039041002,"Block 1002, Block Group 1, Census Tract 39.04, Fayette County, Kentucky",4,3,1
1000000US210670039041003,210670039041003,"Block 1003, Block Group 1, Census Tract 39.04, Fayette County, Kentucky",14,13,1
1000000US210670039041004,210670039041004,"Block 1004, Block Group 1, Census Tract 39.04, Fayette County, Kentucky",8,7,1
1000000US210670039041005,210670039041005,"Block 1005, Block Group 1, Census Tract 39.04, Fayette County, Kentucky",23,21,2
1000000US210670039041006,210670039041006,"Block 1006, Block Group 1, Census Tract 39.04, Fayette County, Kentucky",24,17,7
1000000US210670039041007,210670039041007,"Block 1007, Block Group 1, Census Tract 39.04, Fayette County, Kentucky",23,17,6
1000000US210670039041008,210670039041008,"Block 1008, Block Group 1, Census Tract 39.04, Fayette County, Kentucky",5,5,0
1000000US210670039041009,210670039041009,"Block 1009, Block Group 1, Census Tract 39.04, Fayette County, Kentucky",10,8,2
1000000US210670039041010,210670039041010,"Block 1010, Block Group 1, Census Tract 39.04, Fayette County, Kentucky",17,17,0
1000000US210670039041011,210670039041011,"Block 1011, Block Group 1, Census Tract 39.04, Fayette County, Kentucky",4,4,0
1000000US210670039041012,210670039041012,"Block 1012, Block Group 1, Census Tract 39.04, Fayette County, Kentucky",0,0,0
1000000US210670039041013,210670039041013,"Block 1013, Block Group 1, Census Tract 39.04, Fayette County, Kentucky",9,9,0
1000000US210670039041014,210670039041014,"Block 1014, Block Group 1, Census Tract 39.04, Fayette County, Kentucky",3,3,0
1000000US210670039041015,210670039041015,"Block 1015, Block Group 1, Census Tract 39.04, Fayette County, Kentucky",3,3,0
1000000US210670039041016,210670039041016,"Block 1016, Block Group 1, Census Tract 39.04, Fayette County, Kentucky",0,0,0
1000000US210670039041017,210670039041017,"Block 1017, Block Group 1, Census Tract 39.04, Fayette County, Kentucky",0,0,0
1000000US210670039041018,210670039041018,"Block 1018, Block Group 1, Census Tract 39.04, Fayette County, Kentucky",6,6,0
1000000US210670039041019,210670039041019,"Block 1019, Block Group 1, Census Tract 39.04, Fayette County, Kentucky",6,3,3
1000000US210670039041020,210670039041020,"Block 1020, Block Group 1, Census Tract 39.04, Fayette County, Kentucky",6,5,1
1000000US210670039041021,210670039041021,"Block 1021, Block Group 1, Census Tract 39.04, Fayette County, Kentucky",24,20,4
1000000US210670039041022,210670039041022,"Block 1022, Block Group 1, Census Tract 39.04, Fayette County, Kentucky",247,235,12
1000000US210670039041023,210670039041023,"Block 1023, Block Group 1, Census Tract 39.04, Fayette County, Kentucky",11,10,1
1000000US210670039041024,210670039041024,"Block 1024, Block Group 1, Census Tract 39.04, Fayette County, Kentucky",53,53,0
1000000US210670039041025,210670039041025,"Block 1025, Block Group 1, Census Tract 39.04, Fayette County, Kentucky",34,30,4
1000000US210670039041026,210670039041026,"Block 1026, Block Group 1, Census Tract 39.04, Fayette County, Kentucky",5,4,1
1000000US210670039041027,210670039041027,"Block 1027, Block Group 1, Census Tract 39.04, Fayette County, Kentucky",3,3,0
1000000US210670039041028,210670039041028,"Block 1028, Block Group 1, Census Tract 39.04, Fayette County, Kentucky",0,0,0
1000000US210670039041029,210670039041029,"Block 1029, Block Group 1, Census Tract 39.04, Fayette County, Kentucky",1,1,0
1000000US210670039041030,210670039041030,"Block 1030, Block Group 1, Census Tract 39.04, Fayette County, Kentucky",23,20,3
1000000US210670039041031,210670039041031,"Block 1031, Block Group 1, Census Tract 39.04, Fayette County, Kentucky",13,12,1
1000000US210670039041032,210670039041032,"Block 1032, Block Group 1, Census Tract 39.04, Fayette County, Kentucky",16,15,1
1000000US210670039041033,210670039041033,"Block 1033, Block Group 1, Census Tract 39.04, Fayette County, Kentucky",13,13,0
1000000US210670039041034,210670039041034,"Block 1034, Block Group 1, Census Tract 39.04, Fayette County, Kentucky",50,47,3
1000000US210670039041035,210670039041035,"Block 1035, Block Group 1, Census Tract 39.04, Fayette County, Kentucky",2,1,1
1000000US210670039042000,210670039042000,"Block 2000, Block Group 2, Census Tract 39.04, Fayette County, Kentucky",71,67,4
1000000US210670039042001,210670039042001,"Block 2001, Block Group 2, Census Tract 39.04, Fayette County, Kentucky",32,30,2
1000000US210670039042002,210670039042002,"Block 2002, Block Group 2, Census Tract 39.04, Fayette County, Kentucky",8,8,0
1000000US210670039042003,210670039042003,"Block 2003, Block Group 2, Census Tract 39.04, Fayette County, Kentucky",0,0,0
1000000US210670039042004,210670039042004,"Block 2004, Block Group 2, Census Tract 39.04, Fayette County, Kentucky",57,56,1
1000000US210670039042005,210670039042005,"Block 2005, Block Group 2, Census Tract 39.04, Fayette County, Kentucky",27,24,3
1000000US210670039042006,210670039042006,"Block 2006, Block Group 2, Census Tract 39.04, Fayette County, Kentucky",66,65,1
1000000US210670039042007,210670039042007,"Block 2007, Block Group 2, Census Tract 39.04, Fayette County, Kentucky",27,26,1
1000000US210670039042008,210670039042008,"Block 2008, Block Group 2, Census Tract 39.04, Fayette County, Kentucky",0,0,0
1000000US210670039042009,210670039042009,"Block 2009, Block Group 2, Census Tract 39.04, Fayette County, Kentucky",2,2,0
1000000US210670039042010,210670039042010,"Block 2010, Block Group 2, Census Tract 39.04, Fayette County, Kentucky",4,4,0
1000000US210670039042011,210670039042011,"Block 2011, Block Group 2, Census Tract 39.04, Fayette County, Kentucky",50,48,2
1000000US210670039042012,210670039042012,"Block 2012, Block Group 2, Census Tract 39.04, Fayette County, Kentucky",1,1,0
1000000US210670039042013,210670039042013,"Block 2013, Block Group 2, Census Tract 39.04, Fayette County, Kentucky",6,6,0
1000000US210670039043000,210670039043000,"Block 3000, Block Group 3, Census Tract 39.04, Fayette County, Kentucky",0,0,0
1000000US210670039043001,210670039043001,"Block 3001, Block Group 3, Census Tract 39.04, Fayette County, Kentucky",2,2,0
1000000US210670039043002,210670039043002,"Block 3002, Block Group 3, Census Tract 39.04, Fayette County, Kentucky",20,18,2
1000000US210670039043003,210670039043003,"Block 3003, Block Group 3, Census Tract 39.04, Fayette County, Kentucky",19,17,2
1000000US210670039043004,210670039043004,"Block 3004, Block Group 3, Census Tract 39.04, Fayette County, Kentucky",23,21,2
1000000US210670039043005,210670039043005,"Block 3005, Block Group 3, Census Tract 39.04, Fayette County, Kentucky",26,24,2
1000000US210670039043006,210670039043006,"Block 3006, Block Group 3, Census Tract 39.04, Fayette County, Kentucky",0,0,0
1000000US210670039043007,210670039043007,"Block 3007, Block Group 3, Census Tract 39.04, Fayette County, Kentucky",0,0,0
1000000US210670039043008,210670039043008,"Block 3008, Block Group 3, Census Tract 39.04, Fayette County, Kentucky",0,0,0
1000000US210670039043009,210670039043009,"Block 3009, Block Group 3, Census Tract 39.04, Fayette County, Kentucky",3,3,0
1000000US210670039043010,210670039043010,"Block 3010, Block Group 3, Census Tract 39.04, Fayette County, Kentucky",1,1,0
1000000US210670039043011,210670039043011,"Block 3011, Block Group 3, Census Tract 39.04, Fayette County, Kentucky",37,36,1
1000000US210670039043012,210670039043012,"Block 3012, Block Group 3, Census Tract 39.04, Fayette County, Kentucky",15,14,1
1000000US210670039043013,210670039043013,"Block 3013, Block Group 3, Census Tract 39.04, Fayette County, Kentucky",8,8,0
1000000US210670039043014,210670039043014,"Block 3014, Block Group 3, Census Tract 39.04, Fayette County, Kentucky",0,0,0
1000000US210670039043015,210670039043015,"Block 3015, Block Group 3, Census Tract 39.04, Fayette County, Kentucky",0,0,0
1000000US210670039043016,210670039043016,"Block 3016, Block Group 3, Census Tract 39.04, Fayette County, Kentucky",0,0,0
1000000US210670039043017,210670039043017,"Block 3017, Block Group 3, Census Tract 39.04, Fayette County, Kentucky",0,0,0
1000000US210670039043018,210670039043018,"Block 3018, Block Group 3, Census Tract 39.04, Fayette County, Kentucky",1,1,0
1000000US210670039043019,210670039043019,"Block 3019, Block Group 3, Census Tract 39.04, Fayette County, Kentucky",2,2,0
1000000US210670039043020,210670039043020,"Block 3020, Block Group 3, Census Tract 39.04, Fayette County, Kentucky",3,3,0
1000000US210670039043021,210670039043021,"Block 3021, Block Group 3, Census Tract 39.04, Fayette County, Kentucky",23,23,0
1000000US210670039044000,210670039044000,"Block 4000, Block Group 4, Census Tract 39.04, Fayette County, Kentucky",65,62,3
1000000US210670039044001,210670039044001,"Block 4001, Block Group 4, Census Tract 39.04, Fayette County, Kentucky",1,1,0
1000000US210670039044002,210670039044002,"Block 4002, Block Group 4, Census Tract 39.04, Fayette County, Kentucky",3,3,0
1000000US210670039044003,210670039044003,"Block 4003, Block Group 4, Census Tract 39.04, Fayette County, Kentucky",10,8,2
1000000US210670039044004,210670039044004,"Block 4004, Block Group 4, Census Tract 39.04, Fayette County, Kentucky",2,2,0
1000000US210670039044005,210670039044005,"Block 4005, Block Group 4, Census Tract 39.04, Fayette County, Kentucky",0,0,0
1000000US210670039044006,210670039044006,"Block 4006, Block Group 4, Census Tract 39.04, Fayette County, Kentucky",3,3,0
1000000US210670039044007,210670039044007,"Block 4007, Block Group 4, Census Tract 39.04, Fayette County, Kentucky",0,0,0
1000000US210670039044008,210670039044008,"Block 4008, Block Group 4, Census Tract 39.04, Fayette County, Kentucky",2,2,0
1000000US210670039044009,210670039044009,"Block 4009, Block Group 4, Census Tract 39.04, Fayette County, Kentucky",24,24,0
1000000US210670039044010,210670039044010,"Block 4010, Block Group 4, Census Tract 39.04, Fayette County, Kentucky",1,1,0
1000000US210670039044011,210670039044011,"Block 4011, Block Group 4, Census Tract 39.04, Fayette County, Kentucky",4,3,1
1000000US210670039044012,210670039044012,"Block 4012, Block Group 4, Census Tract 39.04, Fayette County, Kentucky",92,87,5
1000000US210670039044013,210670039044013,"Block 4013, Block Group 4, Census Tract 39.04, Fayette County, Kentucky",66,65,1
1000000US210670039044014,210670039044014,"Block 4014, Block Group 4, Census Tract 39.04, Fayette County, Kentucky",63,60,3
1000000US210670039044015,210670039044015,"Block 4015, Block Group 4, Census Tract 39.04, Fayette County, Kentucky",16,15,1
1000000US210670039044016,210670039044016,"Block 4016, Block Group 4, Census Tract 39.04, Fayette County, Kentucky",12,11,1
1000000US210670039044017,210670039044017,"Block 4017, Block Group 4, Census Tract 39.04, Fayette County, Kentucky",5,4,1
1000000US210670039044018,210670039044018,"Block 4018, Block Group 4, Census Tract 39.04, Fayette County, Kentucky",10,10,0
1000000US210670039044019,210670039044019,"Block 4019, Block Group 4, Census Tract 39.04, Fayette County, Kentucky",0,0,0
1000000US210670039044020,210670039044020,"Block 4020, Block Group 4, Census Tract 39.04, Fayette County, Kentucky",0,0,0
1000000US210670039044021,210670039044021,"Block 4021, Block Group 4, Census Tract 39.04, Fayette County, Kentucky",0,0,0
1000000US210670039044022,210670039044022,"Block 4022, Block Group 4, Census Tract 39.04, Fayette County, Kentucky",0,0,0
1000000US210670039044023,210670039044023,"Block 4023, Block Group 4, Census Tract 39.04, Fayette County, Kentucky",0,0,0
1000000US210670039044024,210670039044024,"Block 4024, Block Group 4, Census Tract 39.04, Fayette County, Kentucky",0,0,0
1000000US210670039044025,210670039044025,"Block 4025, Block Group 4, Census Tract 39.04, Fayette County, Kentucky",0,0,0
1000000US210670039044026,210670039044026,"Block 4026, Block Group 4, Census Tract 39.04, Fayette County, Kentucky",0,0,0
1000000US210670039044027,210670039044027,"Block 4027, Block Group 4, Census Tract 39.04, Fayette County, Kentucky",4,4,0
1000000US210670039044028,210670039044028,"Block 4028, Block Group 4, Census Tract 39.04, Fayette County, Kentucky",2,2,0
1000000US210670039051000,210670039051000,"Block 1000, Block Group 1, Census Tract 39.05, Fayette County, Kentucky",1,1,0
1000000US210670039051001,210670039051001,"Block 1001, Block Group 1, Census Tract 39.05, Fayette County, Kentucky",0,0,0
1000000US210670039051002,210670039051002,"Block 1002, Block Group 1, Census Tract 39.05, Fayette County, Kentucky",299,288,11
1000000US210670039051003,210670039051003,"Block 1003, Block Group 1, Census Tract 39.05, Fayette County, Kentucky",0,0,0
1000000US210670039051004,210670039051004,"Block 1004, Block Group 1, Census Tract 39.05, Fayette County, Kentucky",0,0,0
1000000US210670039051005,210670039051005,"Block 1005, Block Group 1, Census Tract 39.05, Fayette County, Kentucky",0,0,0
1000000US210670039051006,210670039051006,"Block 1006, Block Group 1, Census Tract 39.05, Fayette County, Kentucky",0,0,0
1000000US210670039051007,210670039051007,"Block 1007, Block Group 1, Census Tract 39.05, Fayette County, Kentucky",0,0,0
1000000US210670039051008,210670039051008,"Block 1008, Block Group 1, Census Tract 39.05, Fayette County, Kentucky",0,0,0
1000000US210670039051009,210670039051009,"Block 1009, Block Group 1, Census Tract 39.05, Fayette County, Kentucky",0,0,0
1000000US210670039051010,210670039051010,"Block 1010, Block Group 1, Census Tract 39.05, Fayette County, Kentucky",0,0,0
1000000US210670039051011,210670039051011,"Block 1011, Block Group 1, Census Tract 39.05, Fayette County, Kentucky",0,0,0
1000000US210670039051012,210670039051012,"Block 1012, Block Group 1, Census Tract 39.05, Fayette County, Kentucky",0,0,0
1000000US210670039051013,210670039051013,"Block 1013, Block Group 1, Census Tract 39.05, Fayette County, Kentucky",0,0,0
1000000US210670039051014,210670039051014,"Block 1014, Block Group 1, Census Tract 39.05, Fayette County, Kentucky",0,0,0
1000000US210670039051015,210670039051015,"Block 1015, Block Group 1, Census Tract 39.05, Fayette County, Kentucky",0,0,0
1000000US210670039051016,210670039051016,"Block 1016, Block Group 1, Census Tract 39.05, Fayette County, Kentucky",0,0,0
1000000US210670039051017,210670039051017,"Block 1017, Block Group 1, Census Tract 39.05, Fayette County, Kentucky",53,53,0
1000000US210670039051018,210670039051018,"Block 1018, Block Group 1, Census Tract 39.05, Fayette County, Kentucky",134,129,5
1000000US210670039051019,210670039051019,"Block 1019, Block Group 1, Census Tract 39.05, Fayette County, Kentucky",21,21,0
1000000US210670039051020,210670039051020,"Block 1020, Block Group 1, Census Tract 39.05, Fayette County, Kentucky",39,39,0
1000000US210670039051021,210670039051021,"Block 1021, Block Group 1, Census Tract 39.05, Fayette County, Kentucky",20,20,0
1000000US210670039051022,210670039051022,"Block 1022, Block Group 1, Census Tract 39.05, Fayette County, Kentucky",31,30,1
1000000US210670039051023,210670039051023,"Block 1023, Block Group 1, Census Tract 39.05, Fayette County, Kentucky",6,6,0
1000000US210670039051024,210670039051024,"Block 1024, Block Group 1, Census Tract 39.05, Fayette County, Kentucky",0,0,0
1000000US210670039051025,210670039051025,"Block 1025, Block Group 1, Census Tract 39.05, Fayette County, Kentucky",0,0,0
1000000US210670039051026,210670039051026,"Block 1026, Block Group 1, Census Tract 39.05, Fayette County, Kentucky",0,0,0
1000000US210670039051027,210670039051027,"Block 1027, Block Group 1, Census Tract 39.05, Fayette County, Kentucky",131,117,14
1000000US210670039051028,210670039051028,"Block 1028, Block Group 1, Census Tract 39.05, Fayette County, Kentucky",3,3,0
1000000US210670039051029,210670039051029,"Block 1029, Block Group 1, Census Tract 39.05, Fayette County, Kentucky",15,14,1
1000000US210670039051030,210670039051030,"Block 1030, Block Group 1, Census Tract 39.05, Fayette County, Kentucky",0,0,0
1000000US210670039051031,210670039051031,"Block 1031, Block Group 1, Census Tract 39.05, Fayette County, Kentucky",397,378,19
1000000US210670039051032,210670039051032,"Block 1032, Block Group 1, Census Tract 39.05, Fayette County, Kentucky",19,15,4
1000000US210670039051033,210670039051033,"Block 1033, Block Group 1, Census Tract 39.05, Fayette County, Kentucky",1,1,0
1000000US210670039051034,210670039051034,"Block 1034, Block Group 1, Census Tract 39.05, Fayette County, Kentucky",35,34,1
1000000US210670039051035,210670039051035,"Block 1035, Block Group 1, Census Tract 39.05, Fayette County, Kentucky",160,141,19
1000000US210670039051036,210670039051036,"Block 1036, Block Group 1, Census Tract 39.05, Fayette County, Kentucky",18,17,1
1000000US210670039051037,210670039051037,"Block 1037, Block Group 1, Census Tract 39.05, Fayette County, Kentucky",13,12,1
1000000US210670039051038,210670039051038,"Block 1038, Block Group 1, Census Tract 39.05, Fayette County, Kentucky",17,16,1
1000000US210670039051039,210670039051039,"Block 1039, Block Group 1, Census Tract 39.05, Fayette County, Kentucky",12,12,0
1000000US210670039051040,210670039051040,"Block 1040, Block Group 1, Census Tract 39.05, Fayette County, Kentucky",16,15,1
1000000US210670039051041,210670039051041,"Block 1041, Block Group 1, Census Tract 39.05, Fayette County, Kentucky",30,29,1
1000000US210670039051042,210670039051042,"Block 1042, Block Group 1, Census Tract 39.05, Fayette County, Kentucky",0,0,0
1000000US210670039051043,210670039051043,"Block 1043, Block Group 1, Census Tract 39.05, Fayette County, Kentucky",116,105,11
1000000US210670039051044,210670039051044,"Block 1044, Block Group 1, Census Tract 39.05, Fayette County, Kentucky",0,0,0
1000000US210670039051045,210670039051045,"Block 1045, Block Group 1, Census Tract 39.05, Fayette County, Kentucky",0,0,0
1000000US210670039051046,210670039051046,"Block 1046, Block Group 1, Census Tract 39.05, Fayette County, Kentucky",0,0,0
1000000US210670039061000,210670039061000,"Block 1000, Block Group 1, Census Tract 39.06, Fayette County, Kentucky",33,31,2
1000000US210670039061001,210670039061001,"Block 1001, Block Group 1, Census Tract 39.06, Fayette County, Kentucky",0,0,0
1000000US210670039061002,210670039061002,"Block 1002, Block Group 1, Census Tract 39.06, Fayette County, Kentucky",0,0,0
1000000US210670039061003,210670039061003,"Block 1003, Block Group 1, Census Tract 39.06, Fayette County, Kentucky",91,89,2
1000000US210670039061004,210670039061004,"Block 1004, Block Group 1, Census Tract 39.06, Fayette County, Kentucky",98,97,1
1000000US210670039061005,210670039061005,"Block 1005, Block Group 1, Census Tract 39.06, Fayette County, Kentucky",79,77,2
1000000US210670039061006,210670039061006,"Block 1006, Block Group 1, Census Tract 39.06, Fayette County, Kentucky",56,55,1
1000000US210670039061007,210670039061007,"Block 1007, Block Group 1, Census Tract 39.06, Fayette County, Kentucky",18,18,0
1000000US210670039061008,210670039061008,"Block 1008, Block Group 1, Census Tract 39.06, Fayette County, Kentucky",0,0,0
1000000US210670039061009,210670039061009,"Block 1009, Block Group 1, Census Tract 39.06, Fayette County, Kentucky",27,25,2
1000000US210670039061010,210670039061010,"Block 1010, Block Group 1, Census Tract 39.06, Fayette County, Kentucky",0,0,0
1000000US210670039061011,210670039061011,"Block 1011, Block Group 1, Census Tract 39.06, Fayette County, Kentucky",70,67,3
1000000US210670039061012,210670039061012,"Block 1012, Block Group 1, Census Tract 39.06, Fayette County, Kentucky",51,49,2
1000000US210670039061013,210670039061013,"Block 1013, Block Group 1, Census Tract 39.06, Fayette County, Kentucky",0,0,0
1000000US210670039061014,210670039061014,"Block 1014, Block Group 1, Census Tract 39.06, Fayette County, Kentucky",31,30,1
1000000US210670039061015,210670039061015,"Block 1015, Block Group 1, Census Tract 39.06, Fayette County, Kentucky",115,112,3
1000000US210670039061016,210670039061016,"Block 1016, Block Group 1, Census Tract 39.06, Fayette County, Kentucky",71,69,2
1000000US210670039061017,210670039061017,"Block 1017, Block Group 1, Census Tract 39.06, Fayette County, Kentucky",245,240,5
1000000US210670039061018,210670039061018,"Block 1018, Block Group 1, Census Tract 39.06, Fayette County, Kentucky",6,6,0
1000000US210670039061019,210670039061019,"Block 1019, Block Group 1, Census Tract 39.06, Fayette County, Kentucky",25,25,0
1000000US210670039061020,210670039061020,"Block 1020, Block Group 1, Census Tract 39.06, Fayette County, Kentucky",12,12,0
1000000US210670039061021,210670039061021,"Block 1021, Block Group 1, Census Tract 39.06, Fayette County, Kentucky",15,15,0
1000000US210670039061022,210670039061022,"Block 1022, Block Group 1, Census Tract 39.06, Fayette County, Kentucky",63,63,0
1000000US210670039061023,210670039061023,"Block 1023, Block Group 1, Census Tract 39.06, Fayette County, Kentucky",62,62,0
1000000US210670039061024,210670039061024,"Block 1024, Block Group 1, Census Tract 39.06, Fayette County, Kentucky",32,32,0
1000000US210670039061025,210670039061025,"Block 1025, Block Group 1, Census Tract 39.06, Fayette County, Kentucky",87,86,1
1000000US210670039061026,210670039061026,"Block 1026, Block Group 1, Census Tract 39.06, Fayette County, Kentucky",40,40,0
1000000US210670039061027,210670039061027,"Block 1027, Block Group 1, Census Tract 39.06, Fayette County, Kentucky",13,13,0
1000000US210670039061028,210670039061028,"Block 1028, Block Group 1, Census Tract 39.06, Fayette County, Kentucky",26,26,0
1000000US210670039061029,210670039061029,"Block 1029, Block Group 1, Census Tract 39.06, Fayette County, Kentucky",25,25,0
1000000US210670039061030,210670039061030,"Block 1030, Block Group 1, Census Tract 39.06, Fayette County, Kentucky",27,27,0
1000000US210670039061031,210670039061031,"Block 1031, Block Group 1, Census Tract 39.06, Fayette County, Kentucky",69,68,1
1000000US210670039061032,210670039061032,"Block 1032, Block Group 1, Census Tract 39.06, Fayette County, Kentucky",94,94,0
1000000US210670039061033,210670039061033,"Block 1033, Block Group 1, Census Tract 39.06, Fayette County, Kentucky",25,25,0
1000000US210670039061034,210670039061034,"Block 1034, Block Group 1, Census Tract 39.06, Fayette County, Kentucky",5,5,0
1000000US210670039061035,210670039061035,"Block 1035, Block Group 1, Census Tract 39.06, Fayette County, Kentucky",6,6,0
1000000US210670039061036,210670039061036,"Block 1036, Block Group 1, Census Tract 39.06, Fayette County, Kentucky",2,1,1
1000000US210670039071000,210670039071000,"Block 1000, Block Group 1, Census Tract 39.07, Fayette County, Kentucky",420,405,15
1000000US210670039071001,210670039071001,"Block 1001, Block Group 1, Census Tract 39.07, Fayette County, Kentucky",14,14,0
1000000US210670039071002,210670039071002,"Block 1002, Block Group 1, Census Tract 39.07, Fayette County, Kentucky",37,37,0
1000000US210670039071003,210670039071003,"Block 1003, Block Group 1, Census Tract 39.07, Fayette County, Kentucky",38,32,6
1000000US210670039071004,210670039071004,"Block 1004, Block Group 1, Census Tract 39.07, Fayette County, Kentucky",29,26,3
1000000US210670039071005,210670039071005,"Block 1005, Block Group 1, Census Tract 39.07, Fayette County, Kentucky",211,203,8
1000000US210670039071006,210670039071006,"Block 1006, Block Group 1, Census Tract 39.07, Fayette County, Kentucky",18,14,4
1000000US210670039071007,210670039071007,"Block 1007, Block Group 1, Census Tract 39.07, Fayette County, Kentucky",59,59,0
1000000US210670039071008,210670039071008,"Block 1008, Block Group 1, Census Tract 39.07, Fayette County, Kentucky",78,77,1
1000000US210670039071009,210670039071009,"Block 1009, Block Group 1, Census Tract 39.07, Fayette County, Kentucky",19,18,1
1000000US210670039071010,210670039071010,"Block 1010, Block Group 1, Census Tract 39.07, Fayette County, Kentucky",203,167,36
1000000US210670039071011,210670039071011,"Block 1011, Block Group 1, Census Tract 39.07, Fayette County, Kentucky",101,88,13
1000000US210670039071012,210670039071012,"Block 1012, Block Group 1, Census Tract 39.07, Fayette County, Kentucky",82,74,8
1000000US210670039071013,210670039071013,"Block 1013, Block Group 1, Census Tract 39.07, Fayette County, Kentucky",136,107,29
1000000US210670039071014,210670039071014,"Block 1014, Block Group 1, Census Tract 39.07, Fayette County, Kentucky",977,804,173
1000000US210670039071015,210670039071015,"Block 1015, Block Group 1, Census Tract 39.07, Fayette County, Kentucky",263,248,15
1000000US210670039071016,210670039071016,"Block 1016, Block Group 1, Census Tract 39.07, Fayette County, Kentucky",0,0,0
1000000US210670039071017,210670039071017,"Block 1017, Block Group 1, Census Tract 39.07, Fayette County, Kentucky",0,0,0
1000000US210670039071018,210670039071018,"Block 1018, Block Group 1, Census Tract 39.07, Fayette County, Kentucky",0,0,0
1000000US210670039071019,210670039071019,"Block 1019, Block Group 1, Census Tract 39.07, Fayette County, Kentucky",0,0,0
1000000US210670039071020,210670039071020,"Block 1020, Block Group 1, Census Tract 39.07, Fayette County, Kentucky",0,0,0
1000000US210670039071021,210670039071021,"Block 1021, Block Group 1, Census Tract 39.07, Fayette County, Kentucky",0,0,0
1000000US210670039071022,210670039071022,"Block 1022, Block Group 1, Census Tract 39.07, Fayette County, Kentucky",0,0,0
1000000US210670039071023,210670039071023,"Block 1023, Block Group 1, Census Tract 39.07, Fayette County, Kentucky",0,0,0
1000000US210670039071024,210670039071024,"Block 1024, Block Group 1, Census Tract 39.07, Fayette County, Kentucky",0,0,0
1000000US210670039071025,210670039071025,"Block 1025, Block Group 1, Census Tract 39.07, Fayette County, Kentucky",59,58,1
1000000US210670039071026,210670039071026,"Block 1026, Block Group 1, Census Tract 39.07, Fayette County, Kentucky",45,44,1
1000000US210670039071027,210670039071027,"Block 1027, Block Group 1, Census Tract 39.07, Fayette County, Kentucky",5,4,1
1000000US210670039071028,210670039071028,"Block 1028, Block Group 1, Census Tract 39.07, Fayette County, Kentucky",10,10,0
1000000US210670039071029,210670039071029,"Block 1029, Block Group 1, Census Tract 39.07, Fayette County, Kentucky",0,0,0
1000000US210670039071030,210670039071030,"Block 1030, Block Group 1, Census Tract 39.07, Fayette County, Kentucky",0,0,0
1000000US210670039071031,210670039071031,"Block 1031, Block Group 1, Census Tract 39.07, Fayette County, Kentucky",1,1,0
1000000US210670039071032,210670039071032,"Block 1032, Block Group 1, Census Tract 39.07, Fayette County, Kentucky",0,0,0
1000000US210670040011000,210670040011000,"Block 1000, Block Group 1, Census Tract 40.01, Fayette County, Kentucky",164,155,9
1000000US210670040011001,210670040011001,"Block 1001, Block Group 1, Census Tract 40.01, Fayette County, Kentucky",24,24,0
1000000US210670040011002,210670040011002,"Block 1002, Block Group 1, Census Tract 40.01, Fayette County, Kentucky",21,20,1
1000000US210670040011003,210670040011003,"Block 1003, Block Group 1, Census Tract 40.01, Fayette County, Kentucky",37,35,2
1000000US210670040011004,210670040011004,"Block 1004, Block Group 1, Census Tract 40.01, Fayette County, Kentucky",20,20,0
1000000US210670040011005,210670040011005,"Block 1005, Block Group 1, Census Tract 40.01, Fayette County, Kentucky",86,85,1
1000000US210670040011006,210670040011006,"Block 1006, Block Group 1, Census Tract 40.01, Fayette County, Kentucky",141,139,2
1000000US210670040011007,210670040011007,"Block 1007, Block Group 1, Census Tract 40.01, Fayette County, Kentucky",141,134,7
1000000US210670040011008,210670040011008,"Block 1008, Block Group 1, Census Tract 40.01, Fayette County, Kentucky",42,41,1
1000000US210670040011009,210670040011009,"Block 1009, Block Group 1, Census Tract 40.01, Fayette County, Kentucky",14,14,0
1000000US210670040011010,210670040011010,"Block 1010, Block Group 1, Census Tract 40.01, Fayette County, Kentucky",35,33,2
1000000US210670040011011,210670040011011,"Block 1011, Block Group 1, Census Tract 40.01, Fayette County, Kentucky",137,132,5
1000000US210670040011012,210670040011012,"Block 1012, Block Group 1, Census Tract 40.01, Fayette County, Kentucky",23,22,1
1000000US210670040011013,210670040011013,"Block 1013, Block Group 1, Census Tract 40.01, Fayette County, Kentucky",13,12,1
1000000US210670040012000,210670040012000,"Block 2000, Block Group 2, Census Tract 40.01, Fayette County, Kentucky",195,190,5
1000000US210670040012001,210670040012001,"Block 2001, Block Group 2, Census Tract 40.01, Fayette County, Kentucky",41,41,0
1000000US210670040012002,210670040012002,"Block 2002, Block Group 2, Census Tract 40.01, Fayette County, Kentucky",26,26,0
1000000US210670040012003,210670040012003,"Block 2003, Block Group 2, Census Tract 40.01, Fayette County, Kentucky",593,553,40
1000000US210670040012004,210670040012004,"Block 2004, Block Group 2, Census Tract 40.01, Fayette County, Kentucky",371,343,28
1000000US210670040012005,210670040012005,"Block 2005, Block Group 2, Census Tract 40.01, Fayette County, Kentucky",0,0,0
1000000US210670040012006,210670040012006,"Block 2006, Block Group 2, Census Tract 40.01, Fayette County, Kentucky",52,52,0
1000000US210670040012007,210670040012007,"Block 2007, Block Group 2, Census Tract 40.01, Fayette County, Kentucky",7,7,0
1000000US210670040012008,210670040012008,"Block 2008, Block Group 2, Census Tract 40.01, Fayette County, Kentucky",13,13,0
1000000US210670040012009,210670040012009,"Block 2009, Block Group 2, Census Tract 40.01, Fayette County, Kentucky",89,87,2
1000000US210670040012010,210670040012010,"Block 2010, Block Group 2, Census Tract 40.01, Fayette County, Kentucky",481,384,97
1000000US210670040012011,210670040012011,"Block 2011, Block Group 2, Census Tract 40.01, Fayette County, Kentucky",12,12,0
1000000US210670040012012,210670040012012,"Block 2012, Block Group 2, Census Tract 40.01, Fayette County, Kentucky",24,20,4
1000000US210670040031000,210670040031000,"Block 1000, Block Group 1, Census Tract 40.03, Fayette County, Kentucky",502,447,55
1000000US210670040031001,210670040031001,"Block 1001, Block Group 1, Census Tract 40.03, Fayette County, Kentucky",656,596,60
1000000US210670040031002,210670040031002,"Block 1002, Block Group 1, Census Tract 40.03, Fayette County, Kentucky",686,578,108
1000000US210670040031003,210670040031003,"Block 1003, Block Group 1, Census Tract 40.03, Fayette County, Kentucky",42,42,0
1000000US210670040031004,210670040031004,"Block 1004, Block Group 1, Census Tract 40.03, Fayette County, Kentucky",116,111,5
1000000US210670040031005,210670040031005,"Block 1005, Block Group 1, Census Tract 40.03, Fayette County, Kentucky",48,47,1
1000000US210670040031006,210670040031006,"Block 1006, Block Group 1, Census Tract 40.03, Fayette County, Kentucky",205,204,1
1000000US210670040031007,210670040031007,"Block 1007, Block Group 1, Census Tract 40.03, Fayette County, Kentucky",76,74,2
1000000US210670040031008,210670040031008,"Block 1008, Block Group 1, Census Tract 40.03, Fayette County, Kentucky",71,71,0
1000000US210670040031009,210670040031009,"Block 1009, Block Group 1, Census Tract 40.03, Fayette County, Kentucky",223,219,4
1000000US210670040031010,210670040031010,"Block 1010, Block Group 1, Census Tract 40.03, Fayette County, Kentucky",22,22,0
1000000US210670040031011,210670040031011,"Block 1011, Block Group 1, Census Tract 40.03, Fayette County, Kentucky",21,21,0
1000000US210670040031012,210670040031012,"Block 1012, Block Group 1, Census Tract 40.03, Fayette County, Kentucky",4,4,0
1000000US210670040031013,210670040031013,"Block 1013, Block Group 1, Census Tract 40.03, Fayette County, Kentucky",25,24,1
1000000US210670040031014,210670040031014,"Block 1014, Block Group 1, Census Tract 40.03, Fayette County, Kentucky",29,29,0
1000000US210670040041000,210670040041000,"Block 1000, Block Group 1, Census Tract 40.04, Fayette County, Kentucky",317,315,2
1000000US210670040041001,210670040041001,"Block 1001, Block Group 1, Census Tract 40.04, Fayette County, Kentucky",23,23,0
1000000US210670040041002,210670040041002,"Block 1002, Block Group 1, Census Tract 40.04, Fayette County, Kentucky",14,14,0
1000000US210670040041003,210670040041003,"Block 1003, Block Group 1, Census Tract 40.04, Fayette County, Kentucky",4,4,0
1000000US210670040041004,210670040041004,"Block 1004, Block Group 1, Census Tract 40.04, Fayette County, Kentucky",21,21,0
1000000US210670040041005,210670040041005,"Block 1005, Block Group 1, Census Tract 40.04, Fayette County, Kentucky",23,23,0
1000000US210670040041006,210670040041006,"Block 1006, Block Group 1, Census Tract 40.04, Fayette County, Kentucky",48,48,0
1000000US210670040041007,210670040041007,"Block 1007, Block Group 1, Census Tract 40.04, Fayette County, Kentucky",147,147,0
1000000US210670040041008,210670040041008,"Block 1008, Block Group 1, Census Tract 40.04, Fayette County, Kentucky",147,141,6
1000000US210670040041009,210670040041009,"Block 1009, Block Group 1, Census Tract 40.04, Fayette County, Kentucky",7,7,0
1000000US210670040041010,210670040041010,"Block 1010, Block Group 1, Census Tract 40.04, Fayette County, Kentucky",12,12,0
1000000US210670040041011,210670040041011,"Block 1011, Block Group 1, Census Tract 40.04, Fayette County, Kentucky",34,32,2
1000000US210670040041012,210670040041012,"Block 1012, Block Group 1, Census Tract 40.04, Fayette County, Kentucky",23,22,1
1000000US210670040041013,210670040041013,"Block 1013, Block Group 1, Census Tract 40.04, Fayette County, Kentucky",38,38,0
1000000US210670040041014,210670040041014,"Block 1014, Block Group 1, Census Tract 40.04, Fayette County, Kentucky",24,24,0
1000000US210670040041015,210670040041015,"Block 1015, Block Group 1, Census Tract 40.04, Fayette County, Kentucky",137,136,1
1000000US210670040041016,210670040041016,"Block 1016, Block Group 1, Census Tract 40.04, Fayette County, Kentucky",15,12,3
1000000US210670040041017,210670040041017,"Block 1017, Block Group 1, Census Tract 40.04, Fayette County, Kentucky",26,26,0
1000000US210670040041018,210670040041018,"Block 1018, Block Group 1, Census Tract 40.04, Fayette County, Kentucky",26,26,0
1000000US210670040042000,210670040042000,"Block 2000, Block Group 2, Census Tract 40.04, Fayette County, Kentucky",1,1,0
1000000US210670040042001,210670040042001,"Block 2001, Block Group 2, Census Tract 40.04, Fayette County, Kentucky",15,14,1
1000000US210670040042002,210670040042002,"Block 2002, Block Group 2, Census Tract 40.04, Fayette County, Kentucky",8,8,0
1000000US210670040042003,210670040042003,"Block 2003, Block Group 2, Census Tract 40.04, Fayette County, Kentucky",8,8,0
1000000US210670040042004,210670040042004,"Block 2004, Block Group 2, Census Tract 40.04, Fayette County, Kentucky",3,3,0
1000000US210670040042005,210670040042005,"Block 2005, Block Group 2, Census Tract 40.04, Fayette County, Kentucky",0,0,0
1000000US210670040042006,210670040042006,"Block 2006, Block Group 2, Census Tract 40.04, Fayette County, Kentucky",12,12,0
1000000US210670040042007,210670040042007,"Block 2007, Block Group 2, Census Tract 40.04, Fayette County, Kentucky",18,18,0
1000000US210670040042008,210670040042008,"Block 2008, Block Group 2, Census Tract 40.04, Fayette County, Kentucky",0,0,0
1000000US210670040042009,210670040042009,"Block 2009, Block Group 2, Census Tract 40.04, Fayette County, Kentucky",42,39,3
1000000US210670040042010,210670040042010,"Block 2010, Block Group 2, Census Tract 40.04, Fayette County, Kentucky",29,28,1
1000000US210670040042011,210670040042011,"Block 2011, Block Group 2, Census Tract 40.04, Fayette County, Kentucky",6,6,0
1000000US210670040042012,210670040042012,"Block 2012, Block Group 2, Census Tract 40.04, Fayette County, Kentucky",4,4,0
1000000US210670040042013,210670040042013,"Block 2013, Block Group 2, Census Tract 40.04, Fayette County, Kentucky",9,9,0
1000000US210670040042014,210670040042014,"Block 2014, Block Group 2, Census Tract 40.04, Fayette County, Kentucky",1,1,0
1000000US210670040042015,210670040042015,"Block 2015, Block Group 2, Census Tract 40.04, Fayette County, Kentucky",0,0,0
1000000US210670040042016,210670040042016,"Block 2016, Block Group 2, Census Tract 40.04, Fayette County, Kentucky",24,22,2
1000000US210670040042017,210670040042017,"Block 2017, Block Group 2, Census Tract 40.04, Fayette County, Kentucky",6,6,0
1000000US210670040042018,210670040042018,"Block 2018, Block Group 2, Census Tract 40.04, Fayette County, Kentucky",40,38,2
1000000US210670040042019,210670040042019,"Block 2019, Block Group 2, Census Tract 40.04, Fayette County, Kentucky",0,0,0
1000000US210670040042020,210670040042020,"Block 2020, Block Group 2, Census Tract 40.04, Fayette County, Kentucky",49,45,4
1000000US210670040042021,210670040042021,"Block 2021, Block Group 2, Census Tract 40.04, Fayette County, Kentucky",140,134,6
1000000US210670040042022,210670040042022,"Block 2022, Block Group 2, Census Tract 40.04, Fayette County, Kentucky",37,28,9
1000000US210670040042023,210670040042023,"Block 2023, Block Group 2, Census Tract 40.04, Fayette County, Kentucky",1,0,1
1000000US210670040042024,210670040042024,"Block 2024, Block Group 2, Census Tract 40.04, Fayette County, Kentucky",7,7,0
1000000US210670040042025,210670040042025,"Block 2025, Block Group 2, Census Tract 40.04, Fayette County, Kentucky",5,4,1
1000000US210670040042026,210670040042026,"Block 2026, Block Group 2, Census Tract 40.04, Fayette County, Kentucky",11,10,1
1000000US210670040042027,210670040042027,"Block 2027, Block Group 2, Census Tract 40.04, Fayette County, Kentucky",36,35,1
1000000US210670040042028,210670040042028,"Block 2028, Block Group 2, Census Tract 40.04, Fayette County, Kentucky",7,6,1
1000000US210670040042029,210670040042029,"Block 2029, Block Group 2, Census Tract 40.04, Fayette County, Kentucky",0,0,0
1000000US210670040042030,210670040042030,"Block 2030, Block Group 2, Census Tract 40.04, Fayette County, Kentucky",0,0,0
1000000US210670040042031,210670040042031,"Block 2031, Block Group 2, Census Tract 40.04, Fayette County, Kentucky",0,0,0
1000000US210670040042032,210670040042032,"Block 2032, Block Group 2, Census Tract 40.04, Fayette County, Kentucky",13,13,0
1000000US210670040042033,210670040042033,"Block 2033, Block Group 2, Census Tract 40.04, Fayette County, Kentucky",1,1,0
1000000US210670040042034,210670040042034,"Block 2034, Block Group 2, Census Tract 40.04, Fayette County, Kentucky",14,14,0
1000000US210670040042035,210670040042035,"Block 2035, Block Group 2, Census Tract 40.04, Fayette County, Kentucky",0,0,0
1000000US210670040042036,210670040042036,"Block 2036, Block Group 2, Census Tract 40.04, Fayette County, Kentucky",1,1,0
1000000US210670040042037,210670040042037,"Block 2037, Block Group 2, Census Tract 40.04, Fayette County, Kentucky",13,12,1
1000000US210670040042038,210670040042038,"Block 2038, Block Group 2, Census Tract 40.04, Fayette County, Kentucky",8,6,2
1000000US210670040042039,210670040042039,"Block 2039, Block Group 2, Census Tract 40.04, Fayette County, Kentucky",1,1,0
1000000US210670040042040,210670040042040,"Block 2040, Block Group 2, Census Tract 40.04, Fayette County, Kentucky",88,82,6
1000000US210670040042041,210670040042041,"Block 2041, Block Group 2, Census Tract 40.04, Fayette County, Kentucky",1,1,0
1000000US210670040042042,210670040042042,"Block 2042, Block Group 2, Census Tract 40.04, Fayette County, Kentucky",19,15,4
1000000US210670040042043,210670040042043,"Block 2043, Block Group 2, Census Tract 40.04, Fayette County, Kentucky",0,0,0
1000000US210670040042044,210670040042044,"Block 2044, Block Group 2, Census Tract 40.04, Fayette County, Kentucky",7,7,0
1000000US210670040042045,210670040042045,"Block 2045, Block Group 2, Census Tract 40.04, Fayette County, Kentucky",0,0,0
1000000US210670040042046,210670040042046,"Block 2046, Block Group 2, Census Tract 40.04, Fayette County, Kentucky",0,0,0
1000000US210670040042997,210670040042997,"Block 2997, Block Group 2, Census Tract 40.04, Fayette County, Kentucky",0,0,0
1000000US210670040042998,210670040042998,"Block 2998, Block Group 2, Census Tract 40.04, Fayette County, Kentucky",0,0,0
1000000US210670040042999,210670040042999,"Block 2999, Block Group 2, Census Tract 40.04, Fayette County, Kentucky",0,0,0
1000000US210670041011000,210670041011000,"Block 1000, Block Group 1, Census Tract 41.01, Fayette County, Kentucky",0,0,0
1000000US210670041011001,210670041011001,"Block 1001, Block Group 1, Census Tract 41.01, Fayette County, Kentucky",0,0,0
1000000US210670041011002,210670041011002,"Block 1002, Block Group 1, Census Tract 41.01, Fayette County, Kentucky",6,6,0
1000000US210670041011003,210670041011003,"Block 1003, Block Group 1, Census Tract 41.01, Fayette County, Kentucky",5,5,0
1000000US210670041011004,210670041011004,"Block 1004, Block Group 1, Census Tract 41.01, Fayette County, Kentucky",2,2,0
1000000US210670041011005,210670041011005,"Block 1005, Block Group 1, Census Tract 41.01, Fayette County, Kentucky",263,262,1
1000000US210670041011006,210670041011006,"Block 1006, Block Group 1, Census Tract 41.01, Fayette County, Kentucky",613,575,38
1000000US210670041011007,210670041011007,"Block 1007, Block Group 1, Census Tract 41.01, Fayette County, Kentucky",23,22,1
1000000US210670041011008,210670041011008,"Block 1008, Block Group 1, Census Tract 41.01, Fayette County, Kentucky",135,132,3
1000000US210670041011009,210670041011009,"Block 1009, Block Group 1, Census Tract 41.01, Fayette County, Kentucky",130,126,4
1000000US210670041011010,210670041011010,"Block 1010, Block Group 1, Census Tract 41.01, Fayette County, Kentucky",40,38,2
1000000US210670041011011,210670041011011,"Block 1011, Block Group 1, Census Tract 41.01, Fayette County, Kentucky",88,84,4
1000000US210670041011012,210670041011012,"Block 1012, Block Group 1, Census Tract 41.01, Fayette County, Kentucky",46,45,1
1000000US210670041011013,210670041011013,"Block 1013, Block Group 1, Census Tract 41.01, Fayette County, Kentucky",24,23,1
1000000US210670041011014,210670041011014,"Block 1014, Block Group 1, Census Tract 41.01, Fayette County, Kentucky",317,292,25
1000000US210670041011015,210670041011015,"Block 1015, Block Group 1, Census Tract 41.01, Fayette County, Kentucky",24,24,0
1000000US210670041011016,210670041011016,"Block 1016, Block Group 1, Census Tract 41.01, Fayette County, Kentucky",27,27,0
1000000US210670041011017,210670041011017,"Block 1017, Block Group 1, Census Tract 41.01, Fayette County, Kentucky",62,62,0
1000000US210670041011018,210670041011018,"Block 1018, Block Group 1, Census Tract 41.01, Fayette County, Kentucky",27,27,0
1000000US210670041011019,210670041011019,"Block 1019, Block Group 1, Census Tract 41.01, Fayette County, Kentucky",23,21,2
1000000US210670041011020,210670041011020,"Block 1020, Block Group 1, Census Tract 41.01, Fayette County, Kentucky",125,124,1
1000000US210670041011021,210670041011021,"Block 1021, Block Group 1, Census Tract 41.01, Fayette County, Kentucky",34,34,0
1000000US210670041011022,210670041011022,"Block 1022, Block Group 1, Census Tract 41.01, Fayette County, Kentucky",32,32,0
1000000US210670041011023,210670041011023,"Block 1023, Block Group 1, Census Tract 41.01, Fayette County, Kentucky",68,68,0
1000000US210670041011024,210670041011024,"Block 1024, Block Group 1, Census Tract 41.01, Fayette County, Kentucky",29,27,2
1000000US210670041011025,210670041011025,"Block 1025, Block Group 1, Census Tract 41.01, Fayette County, Kentucky",0,0,0
1000000US210670041011026,210670041011026,"Block 1026, Block Group 1, Census Tract 41.01, Fayette County, Kentucky",107,107,0
1000000US210670041011027,210670041011027,"Block 1027, Block Group 1, Census Tract 41.01, Fayette County, Kentucky",67,65,2
1000000US210670041011028,210670041011028,"Block 1028, Block Group 1, Census Tract 41.01, Fayette County, Kentucky",26,26,0
1000000US210670041011029,210670041011029,"Block 1029, Block Group 1, Census Tract 41.01, Fayette County, Kentucky",61,60,1
1000000US210670041011030,210670041011030,"Block 1030, Block Group 1, Census Tract 41.01, Fayette County, Kentucky",57,57,0
1000000US210670041011031,210670041011031,"Block 1031, Block Group 1, Census Tract 41.01, Fayette County, Kentucky",76,76,0
1000000US210670041021000,210670041021000,"Block 1000, Block Group 1, Census Tract 41.02, Fayette County, Kentucky",0,0,0
1000000US210670041021001,210670041021001,"Block 1001, Block Group 1, Census Tract 41.02, Fayette County, Kentucky",23,23,0
1000000US210670041021002,210670041021002,"Block 1002, Block Group 1, Census Tract 41.02, Fayette County, Kentucky",625,607,18
1000000US210670041021003,210670041021003,"Block 1003, Block Group 1, Census Tract 41.02, Fayette County, Kentucky",57,57,0
1000000US210670041021004,210670041021004,"Block 1004, Block Group 1, Census Tract 41.02, Fayette County, Kentucky",53,52,1
1000000US210670041021005,210670041021005,"Block 1005, Block Group 1, Census Tract 41.02, Fayette County, Kentucky",107,106,1
1000000US210670041021006,210670041021006,"Block 1006, Block Group 1, Census Tract 41.02, Fayette County, Kentucky",35,34,1
1000000US210670041021007,210670041021007,"Block 1007, Block Group 1, Census Tract 41.02, Fayette County, Kentucky",39,38,1
1000000US210670041021008,210670041021008,"Block 1008, Block Group 1, Census Tract 41.02, Fayette County, Kentucky",19,18,1
1000000US210670041021009,210670041021009,"Block 1009, Block Group 1, Census Tract 41.02, Fayette County, Kentucky",47,45,2
1000000US210670041021010,210670041021010,"Block 1010, Block Group 1, Census Tract 41.02, Fayette County, Kentucky",182,178,4
1000000US210670041021011,210670041021011,"Block 1011, Block Group 1, Census Tract 41.02, Fayette County, Kentucky",83,83,0
1000000US210670041021012,210670041021012,"Block 1012, Block Group 1, Census Tract 41.02, Fayette County, Kentucky",68,65,3
1000000US210670041021013,210670041021013,"Block 1013, Block Group 1, Census Tract 41.02, Fayette County, Kentucky",22,22,0
1000000US210670041021014,210670041021014,"Block 1014, Block Group 1, Census Tract 41.02, Fayette County, Kentucky",22,22,0
1000000US210670041021015,210670041021015,"Block 1015, Block Group 1, Census Tract 41.02, Fayette County, Kentucky",16,16,0
1000000US210670041022000,210670041022000,"Block 2000, Block Group 2, Census Tract 41.02, Fayette County, Kentucky",61,56,5
1000000US210670041022001,210670041022001,"Block 2001, Block Group 2, Census Tract 41.02, Fayette County, Kentucky",46,46,0
1000000US210670041022002,210670041022002,"Block 2002, Block Group 2, Census Tract 41.02, Fayette County, Kentucky",11,11,0
1000000US210670041022003,210670041022003,"Block 2003, Block Group 2, Census Tract 41.02, Fayette County, Kentucky",13,12,1
1000000US210670041022004,210670041022004,"Block 2004, Block Group 2, Census Tract 41.02, Fayette County, Kentucky",4,4,0
1000000US210670041022005,210670041022005,"Block 2005, Block Group 2, Census Tract 41.02, Fayette County, Kentucky",161,160,1
1000000US210670041022006,210670041022006,"Block 2006, Block Group 2, Census Tract 41.02, Fayette County, Kentucky",35,35,0
1000000US210670041022007,210670041022007,"Block 2007, Block Group 2, Census Tract 41.02, Fayette County, Kentucky",143,141,2
1000000US210670041022008,210670041022008,"Block 2008, Block Group 2, Census Tract 41.02, Fayette County, Kentucky",0,0,0
1000000US210670041022009,210670041022009,"Block 2009, Block Group 2, Census Tract 41.02, Fayette County, Kentucky",44,43,1
1000000US210670041022010,210670041022010,"Block 2010, Block Group 2, Census Tract 41.02, Fayette County, Kentucky",94,90,4
1000000US210670041022011,210670041022011,"Block 2011, Block Group 2, Census Tract 41.02, Fayette County, Kentucky",0,0,0
1000000US210670041022012,210670041022012,"Block 2012, Block Group 2, Census Tract 41.02, Fayette County, Kentucky",25,24,1
1000000US210670041022013,210670041022013,"Block 2013, Block Group 2, Census Tract 41.02, Fayette County, Kentucky",11,10,1
1000000US210670041022014,210670041022014,"Block 2014, Block Group 2, Census Tract 41.02, Fayette County, Kentucky",20,20,0
1000000US210670041022015,210670041022015,"Block 2015, Block Group 2, Census Tract 41.02, Fayette County, Kentucky",6,5,1
1000000US210670041023000,210670041023000,"Block 3000, Block Group 3, Census Tract 41.02, Fayette County, Kentucky",161,36,125
1000000US210670041023001,210670041023001,"Block 3001, Block Group 3, Census Tract 41.02, Fayette County, Kentucky",210,208,2
1000000US210670041023002,210670041023002,"Block 3002, Block Group 3, Census Tract 41.02, Fayette County, Kentucky",31,31,0
1000000US210670041023003,210670041023003,"Block 3003, Block Group 3, Census Tract 41.02, Fayette County, Kentucky",17,17,0
1000000US210670041023004,210670041023004,"Block 3004, Block Group 3, Census Tract 41.02, Fayette County, Kentucky",14,14,0
1000000US210670041023005,210670041023005,"Block 3005, Block Group 3, Census Tract 41.02, Fayette County, Kentucky",420,409,11
1000000US210670041023006,210670041023006,"Block 3006, Block Group 3, Census Tract 41.02, Fayette County, Kentucky",151,150,1
1000000US210670041023007,210670041023007,"Block 3007, Block Group 3, Census Tract 41.02, Fayette County, Kentucky",146,144,2
1000000US210670041023008,210670041023008,"Block 3008, Block Group 3, Census Tract 41.02, Fayette County, Kentucky",29,29,0
1000000US210670042021000,210670042021000,"Block 1000, Block Group 1, Census Tract 42.02, Fayette County, Kentucky",78,67,11
1000000US210670042021001,210670042021001,"Block 1001, Block Group 1, Census Tract 42.02, Fayette County, Kentucky",3,2,1
1000000US210670042021002,210670042021002,"Block 1002, Block Group 1, Census Tract 42.02, Fayette County, Kentucky",104,101,3
1000000US210670042021003,210670042021003,"Block 1003, Block Group 1, Census Tract 42.02, Fayette County, Kentucky",15,15,0
1000000US210670042021004,210670042021004,"Block 1004, Block Group 1, Census Tract 42.02, Fayette County, Kentucky",27,27,0
1000000US210670042021005,210670042021005,"Block 1005, Block Group 1, Census Tract 42.02, Fayette County, Kentucky",506,354,152
1000000US210670042021006,210670042021006,"Block 1006, Block Group 1, Census Tract 42.02, Fayette County, Kentucky",14,14,0
1000000US210670042021007,210670042021007,"Block 1007, Block Group 1, Census Tract 42.02, Fayette County, Kentucky",24,20,4
1000000US210670042021008,210670042021008,"Block 1008, Block Group 1, Census Tract 42.02, Fayette County, Kentucky",4,3,1
1000000US210670042021009,210670042021009,"Block 1009, Block Group 1, Census Tract 42.02, Fayette County, Kentucky",3,1,2
1000000US210670042021010,210670042021010,"Block 1010, Block Group 1, Census Tract 42.02, Fayette County, Kentucky",0,0,0
1000000US210670042021011,210670042021011,"Block 1011, Block Group 1, Census Tract 42.02, Fayette County, Kentucky",0,0,0
1000000US210670042021012,210670042021012,"Block 1012, Block Group 1, Census Tract 42.02, Fayette County, Kentucky",0,0,0
1000000US210670042021013,210670042021013,"Block 1013, Block Group 1, Census Tract 42.02, Fayette County, Kentucky",0,0,0
1000000US210670042021014,210670042021014,"Block 1014, Block Group 1, Census Tract 42.02, Fayette County, Kentucky",0,0,0
1000000US210670042021015,210670042021015,"Block 1015, Block Group 1, Census Tract 42.02, Fayette County, Kentucky",0,0,0
1000000US210670042021016,210670042021016,"Block 1016, Block Group 1, Census Tract 42.02, Fayette County, Kentucky",0,0,0
1000000US210670042021017,210670042021017,"Block 1017, Block Group 1, Census Tract 42.02, Fayette County, Kentucky",0,0,0
1000000US210670042021018,210670042021018,"Block 1018, Block Group 1, Census Tract 42.02, Fayette County, Kentucky",0,0,0
1000000US210670042021019,210670042021019,"Block 1019, Block Group 1, Census Tract 42.02, Fayette County, Kentucky",52,42,10
1000000US210670042021020,210670042021020,"Block 1020, Block Group 1, Census Tract 42.02, Fayette County, Kentucky",22,21,1
1000000US210670042021021,210670042021021,"Block 1021, Block Group 1, Census Tract 42.02, Fayette County, Kentucky",0,0,0
1000000US210670042021022,210670042021022,"Block 1022, Block Group 1, Census Tract 42.02, Fayette County, Kentucky",0,0,0
1000000US210670042021023,210670042021023,"Block 1023, Block Group 1, Census Tract 42.02, Fayette County, Kentucky",43,41,2
1000000US210670042021024,210670042021024,"Block 1024, Block Group 1, Census Tract 42.02, Fayette County, Kentucky",27,27,0
1000000US210670042021025,210670042021025,"Block 1025, Block Group 1, Census Tract 42.02, Fayette County, Kentucky",20,20,0
1000000US210670042021026,210670042021026,"Block 1026, Block Group 1, Census Tract 42.02, Fayette County, Kentucky",64,63,1
1000000US210670042021027,210670042021027,"Block 1027, Block Group 1, Census Tract 42.02, Fayette County, Kentucky",22,22,0
1000000US210670042021028,210670042021028,"Block 1028, Block Group 1, Census Tract 42.02, Fayette County, Kentucky",72,71,1
1000000US210670042021029,210670042021029,"Block 1029, Block Group 1, Census Tract 42.02, Fayette County, Kentucky",267,245,22
1000000US210670042021030,210670042021030,"Block 1030, Block Group 1, Census Tract 42.02, Fayette County, Kentucky",31,31,0
1000000US210670042021031,210670042021031,"Block 1031, Block Group 1, Census Tract 42.02, Fayette County, Kentucky",5,3,2
1000000US210670042021032,210670042021032,"Block 1032, Block Group 1, Census Tract 42.02, Fayette County, Kentucky",0,0,0
1000000US210670042021033,210670042021033,"Block 1033, Block Group 1, Census Tract 42.02, Fayette County, Kentucky",54,47,7
1000000US210670042021034,210670042021034,"Block 1034, Block Group 1, Census Tract 42.02, Fayette County, Kentucky",261,259,2
1000000US210670042021035,210670042021035,"Block 1035, Block Group 1, Census Tract 42.02, Fayette County, Kentucky",7,7,0
1000000US210670042021036,210670042021036,"Block 1036, Block Group 1, Census Tract 42.02, Fayette County, Kentucky",35,35,0
1000000US210670042021037,210670042021037,"Block 1037, Block Group 1, Census Tract 42.02, Fayette County, Kentucky",17,17,0
1000000US210670042021038,210670042021038,"Block 1038, Block Group 1, Census Tract 42.02, Fayette County, Kentucky",97,94,3
1000000US210670042021039,210670042021039,"Block 1039, Block Group 1, Census Tract 42.02, Fayette County, Kentucky",30,30,0
1000000US210670042021040,210670042021040,"Block 1040, Block Group 1, Census Tract 42.02, Fayette County, Kentucky",15,11,4
1000000US210670042021041,210670042021041,"Block 1041, Block Group 1, Census Tract 42.02, Fayette County, Kentucky",24,20,4
1000000US210670042021042,210670042021042,"Block 1042, Block Group 1, Census Tract 42.02, Fayette County, Kentucky",17,14,3
1000000US210670042021043,210670042021043,"Block 1043, Block Group 1, Census Tract 42.02, Fayette County, Kentucky",95,89,6
1000000US210670042021044,210670042021044,"Block 1044, Block Group 1, Census Tract 42.02, Fayette County, Kentucky",29,29,0
1000000US210670042021045,210670042021045,"Block 1045, Block Group 1, Census Tract 42.02, Fayette County, Kentucky",23,23,0
1000000US210670042021046,210670042021046,"Block 1046, Block Group 1, Census Tract 42.02, Fayette County, Kentucky",26,25,1
1000000US210670042021047,210670042021047,"Block 1047, Block Group 1, Census Tract 42.02, Fayette County, Kentucky",20,20,0
1000000US210670042021048,210670042021048,"Block 1048, Block Group 1, Census Tract 42.02, Fayette County, Kentucky",13,13,0
1000000US210670042021049,210670042021049,"Block 1049, Block Group 1, Census Tract 42.02, Fayette County, Kentucky",24,24,0
1000000US210670042021050,210670042021050,"Block 1050, Block Group 1, Census Tract 42.02, Fayette County, Kentucky",0,0,0
1000000US210670042021051,210670042021051,"Block 1051, Block Group 1, Census Tract 42.02, Fayette County, Kentucky",19,19,0
1000000US210670042021052,210670042021052,"Block 1052, Block Group 1, Census Tract 42.02, Fayette County, Kentucky",16,15,1
1000000US210670042021053,210670042021053,"Block 1053, Block Group 1, Census Tract 42.02, Fayette County, Kentucky",38,36,2
1000000US210670042021054,210670042021054,"Block 1054, Block Group 1, Census Tract 42.02, Fayette County, Kentucky",129,127,2
1000000US210670042021055,210670042021055,"Block 1055, Block Group 1, Census Tract 42.02, Fayette County, Kentucky",139,137,2
1000000US210670042021056,210670042021056,"Block 1056, Block Group 1, Census Tract 42.02, Fayette County, Kentucky",0,0,0
1000000US210670042021057,210670042021057,"Block 1057, Block Group 1, Census Tract 42.02, Fayette County, Kentucky",42,42,0
1000000US210670042021058,210670042021058,"Block 1058, Block Group 1, Census Tract 42.02, Fayette County, Kentucky",12,12,0
1000000US210670042021059,210670042021059,"Block 1059, Block Group 1, Census Tract 42.02, Fayette County, Kentucky",27,27,0
1000000US210670042021060,210670042021060,"Block 1060, Block Group 1, Census Tract 42.02, Fayette County, Kentucky",43,43,0
1000000US210670042022000,210670042022000,"Block 2000, Block Group 2, Census Tract 42.02, Fayette County, Kentucky",54,54,0
1000000US210670042022001,210670042022001,"Block 2001, Block Group 2, Census Tract 42.02, Fayette County, Kentucky",1,1,0
1000000US210670042022002,210670042022002,"Block 2002, Block Group 2, Census Tract 42.02, Fayette County, Kentucky",8,8,0
1000000US210670042022003,210670042022003,"Block 2003, Block Group 2, Census Tract 42.02, Fayette County, Kentucky",0,0,0
1000000US210670042022004,210670042022004,"Block 2004, Block Group 2, Census Tract 42.02, Fayette County, Kentucky",0,0,0
1000000US210670042022005,210670042022005,"Block 2005, Block Group 2, Census Tract 42.02, Fayette County, Kentucky",5,5,0
1000000US210670042022006,210670042022006,"Block 2006, Block Group 2, Census Tract 42.02, Fayette County, Kentucky",0,0,0
1000000US210670042022007,210670042022007,"Block 2007, Block Group 2, Census Tract 42.02, Fayette County, Kentucky",10,8,2
1000000US210670042022008,210670042022008,"Block 2008, Block Group 2, Census Tract 42.02, Fayette County, Kentucky",15,15,0
1000000US210670042022009,210670042022009,"Block 2009, Block Group 2, Census Tract 42.02, Fayette County, Kentucky",3,3,0
1000000US210670042022010,210670042022010,"Block 2010, Block Group 2, Census Tract 42.02, Fayette County, Kentucky",10,10,0
1000000US210670042022011,210670042022011,"Block 2011, Block Group 2, Census Tract 42.02, Fayette County, Kentucky",1,1,0
1000000US210670042022012,210670042022012,"Block 2012, Block Group 2, Census Tract 42.02, Fayette County, Kentucky",10,10,0
1000000US210670042022013,210670042022013,"Block 2013, Block Group 2, Census Tract 42.02, Fayette County, Kentucky",1,1,0
1000000US210670042022014,210670042022014,"Block 2014, Block Group 2, Census Tract 42.02, Fayette County, Kentucky",9,9,0
1000000US210670042022015,210670042022015,"Block 2015, Block Group 2, Census Tract 42.02, Fayette County, Kentucky",19,17,2
1000000US210670042022016,210670042022016,"Block 2016, Block Group 2, Census Tract 42.02, Fayette County, Kentucky",11,10,1
1000000US210670042022017,210670042022017,"Block 2017, Block Group 2, Census Tract 42.02, Fayette County, Kentucky",4,4,0
1000000US210670042022018,210670042022018,"Block 2018, Block Group 2, Census Tract 42.02, Fayette County, Kentucky",1,1,0
1000000US210670042022019,210670042022019,"Block 2019, Block Group 2, Census Tract 42.02, Fayette County, Kentucky",7,6,1
1000000US210670042022020,210670042022020,"Block 2020, Block Group 2, Census Tract 42.02, Fayette County, Kentucky",0,0,0
1000000US210670042022021,210670042022021,"Block 2021, Block Group 2, Census Tract 42.02, Fayette County, Kentucky",30,30,0
1000000US210670042022022,210670042022022,"Block 2022, Block Group 2, Census Tract 42.02, Fayette County, Kentucky",0,0,0
1000000US210670042022023,210670042022023,"Block 2023, Block Group 2, Census Tract 42.02, Fayette County, Kentucky",0,0,0
1000000US210670042022024,210670042022024,"Block 2024, Block Group 2, Census Tract 42.02, Fayette County, Kentucky",81,78,3
1000000US210670042022025,210670042022025,"Block 2025, Block Group 2, Census Tract 42.02, Fayette County, Kentucky",135,135,0
1000000US210670042022026,210670042022026,"Block 2026, Block Group 2, Census Tract 42.02, Fayette County, Kentucky",19,19,0
1000000US210670042022027,210670042022027,"Block 2027, Block Group 2, Census Tract 42.02, Fayette County, Kentucky",6,6,0
1000000US210670042022028,210670042022028,"Block 2028, Block Group 2, Census Tract 42.02, Fayette County, Kentucky",194,190,4
1000000US210670042022029,210670042022029,"Block 2029, Block Group 2, Census Tract 42.02, Fayette County, Kentucky",29,27,2
1000000US210670042022030,210670042022030,"Block 2030, Block Group 2, Census Tract 42.02, Fayette County, Kentucky",2,2,0
1000000US210670042022031,210670042022031,"Block 2031, Block Group 2, Census Tract 42.02, Fayette County, Kentucky",5,4,1
1000000US210670042022032,210670042022032,"Block 2032, Block Group 2, Census Tract 42.02, Fayette County, Kentucky",3,3,0
1000000US210670042022033,210670042022033,"Block 2033, Block Group 2, Census Tract 42.02, Fayette County, Kentucky",2,2,0
1000000US210670042022034,210670042022034,"Block 2034, Block Group 2, Census Tract 42.02, Fayette County, Kentucky",1,1,0
1000000US210670042022035,210670042022035,"Block 2035, Block Group 2, Census Tract 42.02, Fayette County, Kentucky",27,27,0
1000000US210670042022036,210670042022036,"Block 2036, Block Group 2, Census Tract 42.02, Fayette County, Kentucky",87,86,1
1000000US210670042041000,210670042041000,"Block 1000, Block Group 1, Census Tract 42.04, Fayette County, Kentucky",6,5,1
1000000US210670042041001,210670042041001,"Block 1001, Block Group 1, Census Tract 42.04, Fayette County, Kentucky",0,0,0
1000000US210670042041002,210670042041002,"Block 1002, Block Group 1, Census Tract 42.04, Fayette County, Kentucky",4,4,0
1000000US210670042041003,210670042041003,"Block 1003, Block Group 1, Census Tract 42.04, Fayette County, Kentucky",112,107,5
1000000US210670042041004,210670042041004,"Block 1004, Block Group 1, Census Tract 42.04, Fayette County, Kentucky",1,1,0
1000000US210670042041005,210670042041005,"Block 1005, Block Group 1, Census Tract 42.04, Fayette County, Kentucky",0,0,0
1000000US210670042041006,210670042041006,"Block 1006, Block Group 1, Census Tract 42.04, Fayette County, Kentucky",0,0,0
1000000US210670042041007,210670042041007,"Block 1007, Block Group 1, Census Tract 42.04, Fayette County, Kentucky",0,0,0
1000000US210670042041008,210670042041008,"Block 1008, Block Group 1, Census Tract 42.04, Fayette County, Kentucky",17,17,0
1000000US210670042041009,210670042041009,"Block 1009, Block Group 1, Census Tract 42.04, Fayette County, Kentucky",32,32,0
1000000US210670042041010,210670042041010,"Block 1010, Block Group 1, Census Tract 42.04, Fayette County, Kentucky",15,15,0
1000000US210670042041011,210670042041011,"Block 1011, Block Group 1, Census Tract 42.04, Fayette County, Kentucky",28,28,0
1000000US210670042041012,210670042041012,"Block 1012, Block Group 1, Census Tract 42.04, Fayette County, Kentucky",14,14,0
1000000US210670042041013,210670042041013,"Block 1013, Block Group 1, Census Tract 42.04, Fayette County, Kentucky",13,11,2
1000000US210670042041014,210670042041014,"Block 1014, Block Group 1, Census Tract 42.04, Fayette County, Kentucky",44,43,1
1000000US210670042041015,210670042041015,"Block 1015, Block Group 1, Census Tract 42.04, Fayette County, Kentucky",12,12,0
1000000US210670042041016,210670042041016,"Block 1016, Block Group 1, Census Tract 42.04, Fayette County, Kentucky",37,37,0
1000000US210670042041017,210670042041017,"Block 1017, Block Group 1, Census Tract 42.04, Fayette County, Kentucky",13,13,0
1000000US210670042041018,210670042041018,"Block 1018, Block Group 1, Census Tract 42.04, Fayette County, Kentucky",31,31,0
1000000US210670042041019,210670042041019,"Block 1019, Block Group 1, Census Tract 42.04, Fayette County, Kentucky",49,48,1
1000000US210670042041020,210670042041020,"Block 1020, Block Group 1, Census Tract 42.04, Fayette County, Kentucky",29,29,0
1000000US210670042041021,210670042041021,"Block 1021, Block Group 1, Census Tract 42.04, Fayette County, Kentucky",31,28,3
1000000US210670042041022,210670042041022,"Block 1022, Block Group 1, Census Tract 42.04, Fayette County, Kentucky",108,106,2
1000000US210670042041023,210670042041023,"Block 1023, Block Group 1, Census Tract 42.04, Fayette County, Kentucky",51,51,0
1000000US210670042041024,210670042041024,"Block 1024, Block Group 1, Census Tract 42.04, Fayette County, Kentucky",15,15,0
1000000US210670042041025,210670042041025,"Block 1025, Block Group 1, Census Tract 42.04, Fayette County, Kentucky",133,133,0
1000000US210670042041026,210670042041026,"Block 1026, Block Group 1, Census Tract 42.04, Fayette County, Kentucky",3,3,0
1000000US210670042041027,210670042041027,"Block 1027, Block Group 1, Census Tract 42.04, Fayette County, Kentucky",24,24,0
1000000US210670042041028,210670042041028,"Block 1028, Block Group 1, Census Tract 42.04, Fayette County, Kentucky",66,64,2
1000000US210670042041029,210670042041029,"Block 1029, Block Group 1, Census Tract 42.04, Fayette County, Kentucky",71,71,0
1000000US210670042041030,210670042041030,"Block 1030, Block Group 1, Census Tract 42.04, Fayette County, Kentucky",77,75,2
1000000US210670042041031,210670042041031,"Block 1031, Block Group 1, Census Tract 42.04, Fayette County, Kentucky",54,53,1
1000000US210670042041032,210670042041032,"Block 1032, Block Group 1, Census Tract 42.04, Fayette County, Kentucky",9,9,0
1000000US210670042041033,210670042041033,"Block 1033, Block Group 1, Census Tract 42.04, Fayette County, Kentucky",9,9,0
1000000US210670042041034,210670042041034,"Block 1034, Block Group 1, Census Tract 42.04, Fayette County, Kentucky",11,11,0
1000000US210670042041035,210670042041035,"Block 1035, Block Group 1, Census Tract 42.04, Fayette County, Kentucky",139,139,0
1000000US210670042041036,210670042041036,"Block 1036, Block Group 1, Census Tract 42.04, Fayette County, Kentucky",7,7,0
1000000US210670042041037,210670042041037,"Block 1037, Block Group 1, Census Tract 42.04, Fayette County, Kentucky",14,14,0
1000000US210670042041038,210670042041038,"Block 1038, Block Group 1, Census Tract 42.04, Fayette County, Kentucky",0,0,0
1000000US210670042041039,210670042041039,"Block 1039, Block Group 1, Census Tract 42.04, Fayette County, Kentucky",7,7,0
1000000US210670042041040,210670042041040,"Block 1040, Block Group 1, Census Tract 42.04, Fayette County, Kentucky",8,8,0
1000000US210670042041041,210670042041041,"Block 1041, Block Group 1, Census Tract 42.04, Fayette County, Kentucky",38,38,0
1000000US210670042041042,210670042041042,"Block 1042, Block Group 1, Census Tract 42.04, Fayette County, Kentucky",45,45,0
1000000US210670042041043,210670042041043,"Block 1043, Block Group 1, Census Tract 42.04, Fayette County, Kentucky",44,44,0
1000000US210670042041044,210670042041044,"Block 1044, Block Group 1, Census Tract 42.04, Fayette County, Kentucky",44,42,2
1000000US210670042041045,210670042041045,"Block 1045, Block Group 1, Census Tract 42.04, Fayette County, Kentucky",35,34,1
1000000US210670042041046,210670042041046,"Block 1046, Block Group 1, Census Tract 42.04, Fayette County, Kentucky",31,30,1
1000000US210670042041047,210670042041047,"Block 1047, Block Group 1, Census Tract 42.04, Fayette County, Kentucky",5,5,0
1000000US210670042041048,210670042041048,"Block 1048, Block Group 1, Census Tract 42.04, Fayette County, Kentucky",20,19,1
1000000US210670042041049,210670042041049,"Block 1049, Block Group 1, Census Tract 42.04, Fayette County, Kentucky",0,0,0
1000000US210670042041050,210670042041050,"Block 1050, Block Group 1, Census Tract 42.04, Fayette County, Kentucky",1,1,0
1000000US210670042041051,210670042041051,"Block 1051, Block Group 1, Census Tract 42.04, Fayette County, Kentucky",35,34,1
1000000US210670042041052,210670042041052,"Block 1052, Block Group 1, Census Tract 42.04, Fayette County, Kentucky",11,11,0
1000000US210670042041053,210670042041053,"Block 1053, Block Group 1, Census Tract 42.04, Fayette County, Kentucky",89,88,1
1000000US210670042041054,210670042041054,"Block 1054, Block Group 1, Census Tract 42.04, Fayette County, Kentucky",229,193,36
1000000US210670042041055,210670042041055,"Block 1055, Block Group 1, Census Tract 42.04, Fayette County, Kentucky",58,58,0
1000000US210670042041056,210670042041056,"Block 1056, Block Group 1, Census Tract 42.04, Fayette County, Kentucky",25,25,0
1000000US210670042042000,210670042042000,"Block 2000, Block Group 2, Census Tract 42.04, Fayette County, Kentucky",0,0,0
1000000US210670042042001,210670042042001,"Block 2001, Block Group 2, Census Tract 42.04, Fayette County, Kentucky",0,0,0
1000000US210670042042002,210670042042002,"Block 2002, Block Group 2, Census Tract 42.04, Fayette County, Kentucky",0,0,0
1000000US210670042042003,210670042042003,"Block 2003, Block Group 2, Census Tract 42.04, Fayette County, Kentucky",1,1,0
1000000US210670042042004,210670042042004,"Block 2004, Block Group 2, Census Tract 42.04, Fayette County, Kentucky",0,0,0
1000000US210670042051000,210670042051000,"Block 1000, Block Group 1, Census Tract 42.05, Fayette County, Kentucky",97,94,3
1000000US210670042051001,210670042051001,"Block 1001, Block Group 1, Census Tract 42.05, Fayette County, Kentucky",18,17,1
1000000US210670042051002,210670042051002,"Block 1002, Block Group 1, Census Tract 42.05, Fayette County, Kentucky",24,23,1
1000000US210670042051003,210670042051003,"Block 1003, Block Group 1, Census Tract 42.05, Fayette County, Kentucky",86,84,2
1000000US210670042051004,210670042051004,"Block 1004, Block Group 1, Census Tract 42.05, Fayette County, Kentucky",6,6,0
1000000US210670042051005,210670042051005,"Block 1005, Block Group 1, Census Tract 42.05, Fayette County, Kentucky",26,25,1
1000000US210670042051006,210670042051006,"Block 1006, Block Group 1, Census Tract 42.05, Fayette County, Kentucky",33,33,0
1000000US210670042051007,210670042051007,"Block 1007, Block Group 1, Census Tract 42.05, Fayette County, Kentucky",30,30,0
1000000US210670042051008,210670042051008,"Block 1008, Block Group 1, Census Tract 42.05, Fayette County, Kentucky",45,43,2
1000000US210670042051009,210670042051009,"Block 1009, Block Group 1, Census Tract 42.05, Fayette County, Kentucky",26,26,0
1000000US210670042051010,210670042051010,"Block 1010, Block Group 1, Census Tract 42.05, Fayette County, Kentucky",46,46,0
1000000US210670042051011,210670042051011,"Block 1011, Block Group 1, Census Tract 42.05, Fayette County, Kentucky",31,31,0
1000000US210670042051012,210670042051012,"Block 1012, Block Group 1, Census Tract 42.05, Fayette County, Kentucky",35,35,0
1000000US210670042052000,210670042052000,"Block 2000, Block Group 2, Census Tract 42.05, Fayette County, Kentucky",64,64,0
1000000US210670042052001,210670042052001,"Block 2001, Block Group 2, Census Tract 42.05, Fayette County, Kentucky",0,0,0
1000000US210670042052002,210670042052002,"Block 2002, Block Group 2, Census Tract 42.05, Fayette County, Kentucky",14,14,0
1000000US210670042052003,210670042052003,"Block 2003, Block Group 2, Census Tract 42.05, Fayette County, Kentucky",11,11,0
1000000US210670042052004,210670042052004,"Block 2004, Block Group 2, Census Tract 42.05, Fayette County, Kentucky",130,129,1
1000000US210670042052005,210670042052005,"Block 2005, Block Group 2, Census Tract 42.05, Fayette County, Kentucky",241,240,1
1000000US210670042052006,210670042052006,"Block 2006, Block Group 2, Census Tract 42.05, Fayette County, Kentucky",21,21,0
1000000US210670042052007,210670042052007,"Block 2007, Block Group 2, Census Tract 42.05, Fayette County, Kentucky",135,132,3
1000000US210670042052008,210670042052008,"Block 2008, Block Group 2, Census Tract 42.05, Fayette County, Kentucky",28,28,0
1000000US210670042052009,210670042052009,"Block 2009, Block Group 2, Census Tract 42.05, Fayette County, Kentucky",44,44,0
1000000US210670042052010,210670042052010,"Block 2010, Block Group 2, Census Tract 42.05, Fayette County, Kentucky",11,11,0
1000000US210670042052011,210670042052011,"Block 2011, Block Group 2, Census Tract 42.05, Fayette County, Kentucky",179,178,1
1000000US210670042052012,210670042052012,"Block 2012, Block Group 2, Census Tract 42.05, Fayette County, Kentucky",24,24,0
1000000US210670042052013,210670042052013,"Block 2013, Block Group 2, Census Tract 42.05, Fayette County, Kentucky",27,27,0
1000000US210670042052014,210670042052014,"Block 2014, Block Group 2, Census Tract 42.05, Fayette County, Kentucky",23,23,0
1000000US210670042052015,210670042052015,"Block 2015, Block Group 2, Census Tract 42.05, Fayette County, Kentucky",10,9,1
1000000US210670042052016,210670042052016,"Block 2016, Block Group 2, Census Tract 42.05, Fayette County, Kentucky",34,34,0
1000000US210670042052017,210670042052017,"Block 2017, Block Group 2, Census Tract 42.05, Fayette County, Kentucky",6,6,0
1000000US210670042052018,210670042052018,"Block 2018, Block Group 2, Census Tract 42.05, Fayette County, Kentucky",58,57,1
1000000US210670042052019,210670042052019,"Block 2019, Block Group 2, Census Tract 42.05, Fayette County, Kentucky",10,10,0
1000000US210670042052020,210670042052020,"Block 2020, Block Group 2, Census Tract 42.05, Fayette County, Kentucky",93,93,0
1000000US210670042052021,210670042052021,"Block 2021, Block Group 2, Census Tract 42.05, Fayette County, Kentucky",28,28,0
1000000US210670042052022,210670042052022,"Block 2022, Block Group 2, Census Tract 42.05, Fayette County, Kentucky",11,11,0
1000000US210670042052023,210670042052023,"Block 2023, Block Group 2, Census Tract 42.05, Fayette County, Kentucky",144,140,4
1000000US210670042052024,210670042052024,"Block 2024, Block Group 2, Census Tract 42.05, Fayette County, Kentucky",38,38,0
1000000US210670042052025,210670042052025,"Block 2025, Block Group 2, Census Tract 42.05, Fayette County, Kentucky",127,125,2
1000000US210670042052026,210670042052026,"Block 2026, Block Group 2, Census Tract 42.05, Fayette County, Kentucky",43,43,0
1000000US210670042052027,210670042052027,"Block 2027, Block Group 2, Census Tract 42.05, Fayette County, Kentucky",8,8,0
1000000US210670042052028,210670042052028,"Block 2028, Block Group 2, Census Tract 42.05, Fayette County, Kentucky",0,0,0
1000000US210670042052029,210670042052029,"Block 2029, Block Group 2, Census Tract 42.05, Fayette County, Kentucky",0,0,0
1000000US210670042061000,210670042061000,"Block 1000, Block Group 1, Census Tract 42.06, Fayette County, Kentucky",1,1,0
1000000US210670042061001,210670042061001,"Block 1001, Block Group 1, Census Tract 42.06, Fayette County, Kentucky",207,205,2
1000000US210670042061002,210670042061002,"Block 1002, Block Group 1, Census Tract 42.06, Fayette County, Kentucky",15,15,0
1000000US210670042061003,210670042061003,"Block 1003, Block Group 1, Census Tract 42.06, Fayette County, Kentucky",0,0,0
1000000US210670042061004,210670042061004,"Block 1004, Block Group 1, Census Tract 42.06, Fayette County, Kentucky",63,62,1
1000000US210670042061005,210670042061005,"Block 1005, Block Group 1, Census Tract 42.06, Fayette County, Kentucky",1,1,0
1000000US210670042061006,210670042061006,"Block 1006, Block Group 1, Census Tract 42.06, Fayette County, Kentucky",174,170,4
1000000US210670042061007,210670042061007,"Block 1007, Block Group 1, Census Tract 42.06, Fayette County, Kentucky",47,46,1
1000000US210670042061008,210670042061008,"Block 1008, Block Group 1, Census Tract 42.06, Fayette County, Kentucky",32,32,0
1000000US210670042061009,210670042061009,"Block 1009, Block Group 1, Census Tract 42.06, Fayette County, Kentucky",38,38,0
1000000US210670042061010,210670042061010,"Block 1010, Block Group 1, Census Tract 42.06, Fayette County, Kentucky",46,42,4
1000000US210670042061011,210670042061011,"Block 1011, Block Group 1, Census Tract 42.06, Fayette County, Kentucky",24,24,0
1000000US210670042061012,210670042061012,"Block 1012, Block Group 1, Census Tract 42.06, Fayette County, Kentucky",26,26,0
1000000US210670042061013,210670042061013,"Block 1013, Block Group 1, Census Tract 42.06, Fayette County, Kentucky",47,47,0
1000000US210670042061014,210670042061014,"Block 1014, Block Group 1, Census Tract 42.06, Fayette County, Kentucky",39,39,0
1000000US210670042061015,210670042061015,"Block 1015, Block Group 1, Census Tract 42.06, Fayette County, Kentucky",76,76,0
1000000US210670042061016,210670042061016,"Block 1016, Block Group 1, Census Tract 42.06, Fayette County, Kentucky",118,117,1
1000000US210670042061017,210670042061017,"Block 1017, Block Group 1, Census Tract 42.06, Fayette County, Kentucky",73,73,0
1000000US210670042061018,210670042061018,"Block 1018, Block Group 1, Census Tract 42.06, Fayette County, Kentucky",46,44,2
1000000US210670042061019,210670042061019,"Block 1019, Block Group 1, Census Tract 42.06, Fayette County, Kentucky",48,48,0
1000000US210670042061020,210670042061020,"Block 1020, Block Group 1, Census Tract 42.06, Fayette County, Kentucky",58,57,1
1000000US210670042061021,210670042061021,"Block 1021, Block Group 1, Census Tract 42.06, Fayette County, Kentucky",47,47,0
1000000US210670042061022,210670042061022,"Block 1022, Block Group 1, Census Tract 42.06, Fayette County, Kentucky",56,53,3
1000000US210670042061023,210670042061023,"Block 1023, Block Group 1, Census Tract 42.06, Fayette County, Kentucky",12,12,0
1000000US210670042061024,210670042061024,"Block 1024, Block Group 1, Census Tract 42.06, Fayette County, Kentucky",14,14,0
1000000US210670042061025,210670042061025,"Block 1025, Block Group 1, Census Tract 42.06, Fayette County, Kentucky",35,35,0
1000000US210670042061026,210670042061026,"Block 1026, Block Group 1, Census Tract 42.06, Fayette County, Kentucky",30,30,0
1000000US210670042061027,210670042061027,"Block 1027, Block Group 1, Census Tract 42.06, Fayette County, Kentucky",33,31,2
1000000US210670042061028,210670042061028,"Block 1028, Block Group 1, Census Tract 42.06, Fayette County, Kentucky",34,34,0
1000000US210670042061029,210670042061029,"Block 1029, Block Group 1, Census Tract 42.06, Fayette County, Kentucky",98,95,3
1000000US210670042061030,210670042061030,"Block 1030, Block Group 1, Census Tract 42.06, Fayette County, Kentucky",30,30,0
1000000US210670042061031,210670042061031,"Block 1031, Block Group 1, Census Tract 42.06, Fayette County, Kentucky",44,44,0
1000000US210670042061032,210670042061032,"Block 1032, Block Group 1, Census Tract 42.06, Fayette County, Kentucky",12,12,0
1000000US210670042061033,210670042061033,"Block 1033, Block Group 1, Census Tract 42.06, Fayette County, Kentucky",207,204,3
1000000US210670042061034,210670042061034,"Block 1034, Block Group 1, Census Tract 42.06, Fayette County, Kentucky",7,7,0
1000000US210670042061035,210670042061035,"Block 1035, Block Group 1, Census Tract 42.06, Fayette County, Kentucky",9,9,0
1000000US210670042061036,210670042061036,"Block 1036, Block Group 1, Census Tract 42.06, Fayette County, Kentucky",28,28,0
1000000US210670042061037,210670042061037,"Block 1037, Block Group 1, Census Tract 42.06, Fayette County, Kentucky",23,23,0
